xxxxxxxxxxxxxxxxxxxxxxxxxxxxxxxxxxx
x.........................x.......x
x.....xxxx................x.......x             xxxxxxxxxxxxxxxxxxxxxxxxxxxxxxxxxxxxxxxxxxxxxxxxxxxxxxx
x....x.........x..........x...f...x             x.....f.f.f.f.f.f.f.f.f.f.f.f.f.f.f.f.f.f.f.f.f.f.....x
x.........................x.......x             x.....................................................x
x.........................x.......x             x.....................................................x
x.........................x.......x             x.........r...r...r...r...r...r...r...r...r...r.......x
x..........x......................x             x.....................................................x
x.x...............................x             x.....xxxxxxxxxxxxxxxxxxxxxxxxxxxxxxxxxxxxxxxxxxx.....x
x.x...............................x             x.....x                                         x.....x
x.x...............................x             x.....x                                         x.....x
x.xxxx............................x             x.....x                                         x.....x
x.................................x             x.....x                                         x.....x
x.................................x             x..r..x                                         x..r..x
x.................................x             x.....x                                         x.....x
x.................................x             x.....x                                         x.....x
x.................................xxxxxxxxxxxxxxx.....xxxxxxxxxxxxxxxxxxxxxxxxxxxxxxxxxxxxxxxxxxx.....xxxxxxxxxxxxxxxxxxxxxxxxxxxxxxxxxxxxxxxxxxxxxx     
x..........................................................................................................................f................f......x
x.......................................f....................................f...................................................................f.x
x...........x................................................................................................................................f.....x    
x............x........................f..........f.....................................f....................f..................f..........f........x
x.............x.........................................................................................................................f......f...x  
x..............x..................xxxxxxxxxxxxxxxxxxxxxxxxxxxxxxxxxxxxxxxxxxxxxxxxxxxxxxxxxxxxxxxxxxxxxxxxxxxxxxxxxxxxxxxxxxx......................x
x...............x........mmmmm....x                                                                                         x.....f..............f.x       
x..x.............x................x                                                                                         x..f...............f...x       
x................xxxxxxxxxxxx.....x                                                                                         x..........f...........x       
x.................................x                                                                                         x.....f................x       
x.................................x                                                                                         x......................x       
x.................................x                                                                                         xxxxxxxxxxxxxxxxxx.....xxxxxxxxxxxxxxxxxxxxxxxxxxxxxxx       
x.................................x                                                                                                          x...................................x
x.................................x                                                                                                          x..........................r.r.r.r..x
x.................xxx.............x                                                                                                          x...................................x
x....................x............x                                                                                                          x..........................r.r.r.r..x
x...................x.............x                                                                                                          x...................................x
x..................x..............x                                                                                                          x.....xxxxxxxxxxxxxxxxxxxxxxxxxxxxxxx
x.................x...............x                                                                                                          x.....x       
x.................x...............x                                                                                                          x.....x       
x.................x...............x                                                                                                          x.....x       
x.................x...............x                                                                                                          x.....x       
x.................x...............x                                                                                                          x.....x       
x.................x...............x                                                                                                          x.....x       
x....f............................x                                                                                                          x.....x      
x.................................x                                                                                                          x.....x
x...f............f................xxxxxxxxxxxxxxxxxxxxxxxxxxxxxxxxxxxxxxxxxxxxxxxxxxxxxxxxxxxxxxxxxxxxxxxxxxxxxxxxxxxxxxxxxxxxxxxxxxxxxxxxxxxx.....x
x.........x........................................................................................................................................x
x..f...f...x...f......f............................................................................................................................x
x...........x...................................................................................................................................0..x
x..r.r.r.r...x.....f...............................................................................................................................x
x.............x....................................................................................................................................x
xxxxxxxxxxxxxxxxxxxxxxxxxxxxxxxxxxxxxxxxxxxxxxxxxxxxxxxxxxxxxxxxxxxxxxxxxxxxxxxxxxxxxxxxxxxxxxxxxxxxxxxxxxxxxxxxxxxxxxxxxxxxxxxxxxxxxxxxxxxxxxxxxxxx















