x;x;x;x;x;x;x;x;x;x;x;x;x;x;x;x;x;x;x;x;x;x;x;x;x;x;x;x;x;x;x;x;x;x;x;x;x;x;x;_;x;x;x;x;x;x;x;x;x;x;x;x;x;_;_;_;x;x;x;x;x;_;_;_;_;_;_;_;_;_;_;_;x;x;x;x;x;x;x;x;x;x;x;_;_;_;_;_;_;_;x;x;x;x;x;x;x;x;_;_;
x;.;.;.;.;.;.;.;.;.;.;.;.;.;.;.;.;.;.;.;.;.;.;.;.;.;.;.;.;.;.;.;.;.;.;.;.;.;x;x;x;.;.;.;.;.;.;.;.;.;.;.;x;_;_;x;x;.;.;.;x;x;_;_;_;_;_;_;_;_;_;_;x;.;.;.;.;.;.;.;.;.;x;x;x;x;x;_;_;_;x;.;.;.;.;.;.;x;_;_;
x;.;.;.;.;.;.;.;.;.;.;.;.;.;.;.;.;.;.;.;.;.;.;.;.;.;.;.;.;.;.;.;.;.;.;.;.;.;.;.;.;.;.;.;.;.;.;.;.;.;.;.;x;_;x;x;.;.;.;.;.;x;x;_;_;_;_;_;_;_;_;_;x;.;.;.;.;.;m;.;.;.;.;.;x;.;x;x;x;x;x;.;.;.;.;.;x;x;_;_;
x;.;.;.;.;.;m;.;.;.;.;.;.;.;.;.;.;.;.;.;.;.;.;.;.;.;m;.;.;.;.;.;.;.;.;.;.;.;.;.;.;.;.;.;.;.;.;.;.;.;.;.;x;x;x;.;.;.;.;.;.;.;x;_;_;_;_;_;_;_;_;_;x;x;.;.;.;.;.;.;.;.;.;.;.;.;x;.;x;.;.;.;.;.;.;.;x;_;_;_;
x;.;.;.;.;.;.;.;.;.;.;.;.;.;.;.;.;.;.;.;.;.;.;.;.;.;.;.;.;.;.;.;.;.;.;.;.;.;.;.;.;.;.;.;.;.;.;.;.;.;.;.;x;x;.;.;.;.;.;.;.;x;x;_;_;_;_;_;_;_;_;_;_;x;x;x;.;.;.;.;.;.;m;.;.;.;x;.;x;.;.;.;.;.;x;x;x;_;_;_;
x;.;.;.;.;.;.;.;.;.;.;.;.;.;.;.;.;.;.;.;.;.;.;.;.;.;.;.;.;.;.;.;.;.;.;.;.;x;.;.;.;.;.;x;x;x;.;.;.;.;.;.;.;.;.;m;.;.;.;.;.;x;x;x;x;_;_;x;x;x;_;_;_;_;_;x;x;x;x;x;.;.;.;.;.;.;.;.;.;.;.;.;.;.;x;_;_;_;_;_;
x;.;.;.;.;.;.;.;.;.;.;.;.;.;.;.;.;.;.;.;.;.;.;.;.;.;.;.;.;.;.;.;.;.;.;.;.;x;x;x;.;.;.;x;x;x;x;.;.;.;.;.;.;.;.;.;.;.;.;.;x;x;x;.;x;x;x;x;.;x;_;x;x;x;x;_;_;_;x;x;.;.;.;.;.;.;.;.;.;.;.;.;.;x;x;_;_;_;_;_;
x;.;.;.;.;.;.;.;.;.;.;.;.;.;.;.;.;x;x;x;x;.;.;.;.;.;.;.;.;.;.;.;.;.;.;.;x;x;x;x;.;r;.;.;.;x;x;x;x;.;.;.;.;.;.;.;.;.;.;.;x;x;x;.;.;.;.;.;.;x;x;x;.;.;x;_;x;x;x;.;.;.;.;.;.;.;.;.;.;.;.;.;x;x;x;x;x;x;x;x;
x;.;.;.;.;.;f;.;.;.;.;.;.;.;.;.;.;x;x;x;x;.;.;.;.;.;.;.;.;.;.;.;.;.;.;x;x;x;x;.;.;.;.;.;.;x;_;_;x;x;.;.;.;.;.;.;.;.;.;.;.;.;.;.;.;.;.;.;.;.;x;x;x;x;x;x;x;.;x;.;.;.;.;.;.;m;.;.;.;.;.;.;x;.;.;.;.;.;.;x;
x;.;.;.;.;.;.;.;.;.;.;.;.;.;.;.;.;.;.;.;x;.;.;.;.;.;.;.;.;.;.;.;.;x;x;x;x;.;.;.;.;.;.;.;.;x;_;_;_;x;.;.;.;.;.;.;.;.;.;.;.;.;.;.;.;.;.;.;.;.;x;x;.;.;.;.;x;.;.;.;.;.;.;.;.;.;.;.;.;.;.;.;.;.;.;.;.;.;.;x;
x;.;.;.;.;.;.;.;.;.;.;.;.;.;.;.;.;.;.;.;.;.;.;.;.;.;.;.;.;.;.;.;.;x;_;x;.;.;.;.;.;.;.;.;x;x;_;_;_;x;.;.;.;.;.;x;x;x;x;.;.;.;.;.;.;.;.;.;.;.;x;x;x;.;.;.;.;.;.;.;.;.;.;.;.;.;.;.;.;.;.;.;.;.;.;.;.;.;.;x;
x;.;.;.;.;.;.;.;.;.;.;.;.;x;x;.;.;.;.;.;.;x;x;.;.;.;.;.;.;.;.;.;.;x;x;x;.;.;.;.;.;.;.;.;x;x;x;x;x;x;.;.;.;.;.;x;_;x;.;.;.;.;.;.;.;.;.;.;.;x;x;x;.;.;.;.;.;.;.;.;.;.;.;.;.;.;.;.;.;.;.;.;.;.;.;.;.;.;x;x;
x;.;.;.;.;.;.;.;.;.;.;.;.;x;x;x;x;.;.;.;x;x;.;.;.;.;x;.;.;.;.;.;.;x;x;.;.;.;.;.;.;.;.;x;x;x;.;.;x;.;.;.;.;.;.;x;x;x;x;.;.;.;.;.;.;.;.;.;.;x;_;x;x;.;.;.;.;.;.;.;.;.;.;.;.;.;.;.;.;.;.;f;.;.;.;.;x;x;x;_;
x;.;.;.;.;.;.;.;.;.;.;.;.;x;_;_;x;x;x;x;x;x;.;.;.;.;.;.;.;.;.;.;x;x;x;x;.;.;.;.;.;.;.;.;.;.;.;.;.;.;.;.;.;.;.;.;x;.;.;.;.;m;.;.;.;.;.;.;x;x;_;_;x;x;.;.;x;x;.;.;.;.;.;.;.;.;x;x;x;.;.;.;.;.;x;x;x;_;_;_;
x;.;.;.;.;.;0;.;.;.;.;.;.;x;x;_;_;_;_;x;x;.;.;.;.;.;.;.;.;.;.;.;x;_;x;.;.;.;.;.;.;.;.;.;.;.;.;.;.;.;.;.;.;.;.;.;.;.;.;.;.;.;.;.;.;.;.;.;x;x;_;_;_;x;.;.;.;x;.;.;.;.;.;.;.;x;x;.;x;.;x;x;x;x;x;_;_;_;_;_;
x;.;.;.;.;.;.;.;.;.;.;.;.;.;x;x;_;_;_;x;.;.;.;.;.;.;.;.;.;.;.;.;x;x;x;x;.;.;.;.;.;.;.;f;.;.;.;.;.;.;.;.;.;.;.;.;.;.;.;.;.;.;.;.;.;.;p;.;.;x;x;_;x;x;x;.;x;x;x;.;.;.;.;.;.;x;.;.;.;.;x;x;_;_;_;x;x;x;_;_;
x;.;.;.;.;.;.;.;.;.;.;.;.;.;.;x;x;x;x;x;.;.;.;.;.;.;.;.;.;.;.;.;x;.;.;.;.;.;.;x;.;.;.;.;.;.;.;.;.;r;.;.;.;.;.;.;.;.;.;.;.;.;.;.;x;.;.;.;.;.;x;x;x;.;.;.;.;.;x;.;.;.;.;.;.;.;.;.;.;.;.;x;x;x;x;x;.;x;x;x;
x;.;.;.;.;.;.;.;.;.;.;.;.;.;x;.;x;.;.;.;.;.;.;.;.;.;.;.;.;.;.;.;.;.;.;.;.;x;x;x;x;.;.;.;.;.;.;.;.;.;.;.;.;.;.;.;.;.;.;.;.;.;x;x;x;x;.;.;.;.;.;.;x;.;.;.;.;.;.;.;.;.;.;.;.;x;.;.;.;.;.;.;.;x;x;.;.;.;.;x;
x;x;.;.;.;.;.;.;.;.;.;.;.;.;.;.;.;.;x;x;.;.;.;.;.;.;.;.;.;.;.;.;.;.;.;.;.;x;_;x;x;.;.;.;.;.;.;.;.;.;.;.;.;.;.;.;.;.;.;.;.;x;x;x;_;x;x;.;.;.;.;.;x;.;x;.;.;.;.;.;.;.;.;.;x;x;.;.;.;.;.;.;.;.;.;.;.;.;.;x;
x;.;.;.;.;.;.;.;.;.;x;x;x;x;x;.;x;.;x;x;x;.;.;.;.;.;.;.;.;.;.;.;.;.;.;.;.;x;x;x;.;.;.;.;.;.;.;.;.;.;.;.;.;.;.;.;.;.;.;.;.;.;.;x;x;x;x;.;.;.;.;.;x;x;x;x;.;.;.;.;.;.;.;.;x;x;.;x;.;x;.;.;.;.;.;.;.;.;.;x;
x;x;.;.;.;.;.;.;.;x;x;_;x;.;.;.;.;x;x;x;x;.;.;.;.;.;.;.;x;x;.;.;.;.;.;.;.;.;.;.;.;.;.;.;.;.;.;.;.;.;.;.;.;.;.;.;.;.;.;.;.;.;.;x;.;x;x;x;.;.;.;x;x;_;_;x;x;.;.;.;.;.;.;.;x;x;.;.;.;x;.;.;.;.;.;.;.;.;.;x;
x;.;.;.;.;.;.;.;.;x;_;_;x;x;x;x;x;x;.;.;.;.;.;.;.;.;.;x;x;.;.;.;.;.;.;.;.;.;.;.;.;.;.;.;.;.;.;.;.;.;.;.;x;x;x;x;.;.;.;.;.;.;.;x;.;x;x;.;.;.;.;x;_;_;_;x;x;.;.;.;.;.;.;.;x;.;.;.;.;x;x;.;.;.;.;.;.;.;.;x;
x;x;.;.;.;.;.;.;.;x;x;x;x;.;.;.;.;.;.;f;.;m;.;.;.;.;.;.;.;.;.;.;.;.;.;.;.;.;.;.;.;.;.;.;.;.;.;.;.;.;x;.;x;x;x;x;x;x;.;x;.;x;.;.;.;x;x;x;.;.;.;x;x;_;x;x;.;.;.;.;.;.;.;.;.;.;.;.;.;.;x;x;x;.;.;.;.;.;.;x;
x;.;.;.;.;.;.;.;x;x;x;.;x;.;.;.;x;.;.;.;.;.;.;.;.;.;.;.;.;.;.;.;.;.;.;.;.;.;.;.;.;.;.;.;.;.;.;.;.;.;.;.;.;.;x;x;.;.;.;x;x;x;.;.;.;x;x;.;.;.;.;.;x;x;x;.;.;.;.;.;.;.;.;.;.;.;.;.;.;.;x;.;x;x;x;.;.;.;x;x;
x;x;x;.;.;.;.;x;x;.;.;.;.;.;.;.;.;.;.;.;.;.;.;m;.;.;.;r;.;.;.;.;.;.;.;.;.;.;.;.;.;.;.;.;.;.;.;.;.;.;.;.;.;.;x;x;x;x;x;x;_;x;x;.;.;.;x;.;.;.;.;.;.;x;.;.;.;.;.;.;.;.;x;.;x;.;.;f;.;.;.;.;.;x;x;.;x;x;x;_;
_;x;.;.;.;x;x;x;.;.;.;.;.;.;.;x;x;x;.;.;.;.;.;.;.;.;.;.;.;m;.;.;.;.;.;.;.;.;.;f;.;.;.;.;.;.;.;.;.;.;.;.;.;.;.;.;.;.;x;_;_;_;x;.;.;.;.;.;.;.;.;.;.;.;.;.;.;.;.;.;.;.;x;x;.;.;.;.;.;.;.;.;.;x;x;x;.;x;_;_;
_;x;.;x;x;x;x;.;.;.;.;.;.;.;.;x;x;x;x;.;.;.;.;.;.;.;.;.;.;.;.;.;.;.;.;.;.;.;.;.;.;.;.;.;.;.;.;.;.;.;.;.;.;.;.;.;.;.;x;x;_;_;x;.;.;.;.;.;.;.;.;.;.;.;.;.;.;.;.;.;.;x;x;x;x;.;.;.;.;.;.;.;.;x;_;x;.;x;x;x;
_;x;.;x;.;x;x;x;.;.;.;.;.;.;.;x;.;.;.;.;.;f;.;.;.;.;.;.;.;.;.;.;.;.;.;.;.;.;.;.;.;.;.;.;.;.;.;.;.;.;.;.;.;.;.;f;.;.;.;x;_;_;x;.;.;.;.;.;.;.;.;.;m;.;.;.;.;.;.;.;.;x;x;x;.;.;.;.;.;.;.;.;.;x;_;x;.;x;.;x;
_;x;.;x;x;x;_;x;.;.;.;.;.;.;.;.;.;.;.;.;.;.;.;.;.;.;.;.;.;.;.;.;.;.;.;.;.;.;.;.;.;.;.;.;.;.;.;.;.;.;.;.;.;.;.;.;.;.;.;x;_;_;x;.;.;.;.;.;.;.;.;.;.;.;.;.;.;.;.;.;x;x;x;.;.;.;.;.;.;.;.;.;x;x;_;x;.;x;x;x;
_;x;x;x;_;_;_;x;x;.;.;.;.;.;.;.;.;.;.;.;.;.;f;.;.;.;.;.;.;.;.;.;x;x;x;.;.;.;.;.;.;.;.;.;.;.;.;.;.;.;.;.;.;.;.;.;.;.;x;x;x;x;x;x;.;.;.;.;.;.;.;.;.;.;.;.;.;.;.;.;.;.;.;.;.;.;.;.;.;.;.;.;x;_;_;x;x;x;_;_;
_;_;_;_;_;_;_;_;x;x;.;.;.;.;.;.;.;.;.;.;.;.;.;.;.;.;.;.;.;.;.;.;.;.;.;.;.;.;.;.;.;.;.;.;.;.;.;.;.;x;x;x;.;.;.;.;.;.;x;x;.;x;x;x;x;.;.;.;.;.;.;.;.;.;.;.;.;.;.;.;.;.;.;.;.;.;.;.;.;.;.;.;x;_;_;_;_;_;_;_;
_;_;x;x;x;x;x;x;x;x;x;x;x;.;.;.;.;.;.;.;.;.;.;.;.;.;m;.;.;.;.;.;.;.;.;.;.;.;.;.;.;.;.;.;.;.;.;.;.;.;x;.;x;.;.;.;.;x;x;.;.;.;.;x;x;.;.;.;r;.;.;.;.;.;.;.;.;.;.;.;.;.;.;.;.;.;.;.;.;.;.;.;x;_;_;x;x;x;x;x;
_;x;x;.;.;.;.;.;.;x;x;x;x;.;.;.;.;.;.;.;.;.;.;.;.;.;.;.;.;.;.;.;.;.;.;.;.;.;.;.;.;.;.;.;.;.;.;.;.;.;.;.;.;.;.;.;.;.;.;.;.;.;.;.;.;.;.;.;.;.;.;.;.;.;.;.;.;.;.;.;.;.;.;.;.;m;.;.;.;.;.;.;x;x;_;x;.;.;.;x;
_;x;.;.;.;.;.;.;.;.;.;.;.;.;.;.;.;.;x;x;.;.;.;.;.;r;.;.;.;.;.;.;.;.;.;.;.;.;.;.;.;.;.;.;.;.;.;.;.;.;.;.;.;.;.;.;.;.;.;.;.;.;.;.;.;.;.;.;.;.;.;.;.;.;x;x;.;r;.;.;.;.;.;.;.;.;.;.;.;.;.;.;.;x;x;x;.;.;.;x;
x;x;.;.;.;.;.;.;.;.;.;.;.;.;.;.;.;.;x;x;x;.;.;.;.;.;.;.;.;.;x;x;x;.;.;x;.;r;.;.;.;.;.;.;.;.;.;.;.;.;.;.;.;x;x;.;.;.;.;.;.;.;.;.;.;.;.;.;.;.;.;.;.;.;x;.;.;.;.;.;.;.;.;.;.;.;.;.;.;.;.;.;.;x;x;.;.;.;.;x;
x;.;.;.;r;.;.;.;.;.;.;.;.;.;.;.;.;.;x;_;x;x;.;.;.;.;.;.;.;.;x;_;x;x;x;x;.;.;.;.;.;.;x;.;.;.;.;.;.;.;.;.;x;x;x;.;.;.;.;.;.;.;.;.;.;.;.;.;.;.;.;.;.;.;x;.;.;.;.;.;.;x;.;x;.;.;.;.;.;.;.;.;.;.;x;x;.;.;.;x;
x;.;.;.;.;.;.;.;.;.;.;.;.;.;.;.;.;.;x;_;_;x;x;x;.;.;.;.;.;x;x;_;_;_;x;x;.;.;.;.;.;.;.;.;.;.;.;.;.;.;.;x;x;_;x;x;x;.;.;.;.;.;.;.;.;.;.;.;.;.;.;.;.;.;.;.;.;.;.;.;.;x;x;x;.;.;.;.;.;.;.;.;.;.;.;x;.;.;.;x;
x;.;.;.;.;.;.;.;.;.;.;.;.;.;.;.;.;.;x;x;_;_;_;x;x;.;.;.;.;.;x;_;_;_;x;.;.;.;.;.;.;.;.;.;.;.;.;.;.;.;.;.;x;_;_;_;x;.;.;m;.;.;.;.;.;.;.;.;r;.;.;.;.;.;x;.;.;.;.;.;x;x;_;x;x;.;.;.;.;.;.;.;.;.;.;x;x;x;x;x;
x;x;.;.;.;.;x;x;x;x;x;.;.;.;.;.;.;.;.;x;x;_;x;x;.;.;.;.;.;x;x;x;_;_;x;x;.;.;.;.;.;.;.;.;.;.;.;.;.;.;.;.;x;x;x;_;x;.;.;.;.;.;.;.;.;.;.;.;.;.;.;.;.;x;x;.;.;.;.;x;x;_;_;_;x;.;.;.;.;.;.;.;.;.;.;x;x;x;x;_;
_;x;.;.;.;x;x;x;x;_;x;.;.;.;.;.;.;.;.;.;x;x;x;.;.;.;.;.;.;.;.;x;_;_;_;x;.;.;.;.;.;.;.;.;.;.;.;.;.;.;.;.;.;.;x;_;x;x;.;.;.;.;.;.;.;.;m;.;.;.;.;.;x;x;x;x;x;.;.;x;x;x;x;x;x;.;.;.;.;.;.;.;.;x;x;x;x;.;x;x;
_;x;x;x;.;.;.;.;x;x;x;x;.;.;.;.;.;.;.;.;x;.;x;.;.;.;.;.;.;x;x;x;x;x;x;x;.;.;.;.;.;.;.;.;.;.;.;.;.;.;.;.;.;.;x;x;_;x;x;.;.;.;.;.;.;.;.;.;.;.;.;x;x;_;_;x;x;x;x;x;x;.;.;.;.;.;.;.;.;.;x;x;x;x;_;x;x;.;.;x;
_;x;.;.;.;.;.;.;.;x;x;x;.;.;.;.;.;.;.;.;.;.;.;.;.;.;.;.;.;.;.;.;.;x;x;.;.;.;.;.;.;.;.;.;.;.;.;.;.;.;.;.;.;.;.;x;_;_;x;x;x;x;x;x;.;.;.;.;.;.;.;.;x;x;x;x;.;.;.;.;.;.;.;.;.;.;.;.;.;.;.;.;x;x;x;x;.;.;.;x;
x;x;.;.;.;.;.;.;.;.;x;x;x;.;.;.;.;.;.;.;.;.;.;.;.;.;.;.;.;.;.;.;x;x;.;.;.;.;.;.;.;.;.;x;.;.;.;.;.;.;.;m;.;.;x;x;_;_;_;_;_;_;_;x;x;.;.;.;.;.;.;.;.;x;.;.;.;.;.;.;.;.;.;.;.;.;.;.;.;.;.;.;.;.;x;x;.;.;.;x;
x;.;.;.;.;.;.;.;.;.;x;x;x;.;.;.;.;.;.;.;.;.;.;.;.;.;.;.;.;.;.;.;.;.;.;.;.;.;.;.;.;.;.;x;x;x;.;.;.;.;.;.;.;.;.;x;x;_;_;_;_;_;_;_;x;.;.;.;.;.;.;.;.;.;.;.;.;.;.;.;.;.;.;.;.;.;.;.;.;.;.;.;.;.;.;.;.;.;.;x;
x;.;.;f;.;.;.;.;.;.;.;x;.;.;.;.;.;.;.;.;.;.;.;.;.;.;.;.;.;.;.;.;.;.;.;.;.;.;.;.;.;.;.;x;x;x;.;.;.;.;.;.;.;.;x;.;x;x;x;_;_;_;_;_;x;.;.;.;.;.;.;.;.;.;.;.;.;r;.;.;.;.;.;.;.;.;.;.;.;.;.;.;.;.;.;.;.;.;.;x;
x;.;.;.;.;.;.;.;.;.;.;.;.;.;.;.;.;.;.;.;.;.;.;.;.;.;.;.;.;.;.;.;.;.;.;.;.;.;.;.;.;.;.;.;x;.;.;.;.;.;.;.;.;.;.;.;.;.;x;_;_;_;_;_;x;x;.;.;.;.;.;.;.;.;x;.;.;.;.;.;.;.;.;.;.;.;.;r;.;.;.;.;.;.;.;.;.;.;.;x;
x;.;.;.;.;.;.;.;.;.;.;.;.;.;.;.;.;.;.;.;.;.;.;.;.;.;.;.;.;.;.;.;.;.;.;.;.;.;.;.;.;.;.;.;.;.;.;.;.;.;.;.;.;.;.;.;.;.;x;x;_;_;_;_;_;x;x;.;.;.;.;.;.;.;.;.;.;.;.;.;.;.;.;.;.;.;.;.;.;.;x;.;x;.;.;.;.;.;.;x;
x;.;.;.;.;.;.;.;.;.;.;.;.;.;.;x;x;.;.;.;.;.;.;.;.;.;.;.;.;.;.;.;.;.;r;.;.;.;.;.;.;.;.;.;.;.;.;.;.;.;.;.;.;.;.;.;.;.;.;x;_;_;_;x;x;x;x;x;.;.;m;.;.;.;.;.;.;.;.;x;x;x;.;.;.;.;.;.;x;.;x;x;x;x;.;.;.;.;.;x;
x;.;.;.;.;.;.;.;.;.;.;.;.;.;.;.;.;.;.;.;.;.;.;.;.;.;.;.;.;.;.;.;.;.;.;.;.;.;.;.;.;.;.;.;.;.;.;.;.;.;.;.;.;.;.;.;.;.;x;x;_;x;x;x;.;x;x;x;.;.;.;.;.;.;.;.;.;.;x;x;_;x;x;.;.;.;x;x;x;x;x;_;_;x;x;.;.;.;x;x;
x;.;.;.;.;.;.;m;.;.;.;.;.;.;.;.;.;.;.;.;.;.;.;.;.;.;.;.;.;.;.;.;.;.;.;.;.;.;.;.;.;.;.;.;.;.;.;.;.;.;.;.;.;.;.;.;.;.;.;x;x;x;.;.;.;.;.;.;.;.;.;.;.;.;.;.;.;.;x;x;_;_;x;x;x;x;x;_;x;x;x;x;_;_;x;x;x;x;x;_;
x;x;.;.;.;.;.;.;.;.;.;.;.;.;.;.;.;.;.;.;.;.;.;.;.;.;.;.;.;.;f;.;.;.;.;.;.;.;.;.;.;.;.;.;.;.;.;.;.;.;.;.;.;.;.;.;.;.;x;x;.;x;.;.;.;.;.;.;.;.;.;.;.;.;.;.;.;.;.;x;_;_;x;x;x;_;x;x;x;.;.;x;x;x;x;x;_;_;_;_;
x;.;.;.;.;.;.;.;.;.;.;.;.;.;.;.;.;.;.;.;.;.;.;.;.;.;.;.;.;.;.;.;.;.;.;.;.;.;.;.;.;.;.;.;.;.;.;.;.;.;.;.;.;.;.;.;.;.;.;.;.;.;.;.;.;.;.;.;.;.;.;r;.;.;.;.;.;.;.;x;x;x;x;.;x;x;x;.;.;.;.;.;.;.;.;x;x;_;_;_;
x;x;.;.;.;.;.;.;.;.;.;.;.;.;.;x;.;x;.;.;.;.;.;.;.;.;.;.;.;.;.;.;x;x;x;x;.;.;.;.;.;.;.;.;.;.;.;.;.;.;.;.;.;.;.;.;.;.;.;.;.;.;.;.;.;.;.;.;.;.;.;.;.;.;.;.;.;.;.;x;x;.;.;.;.;.;.;.;.;.;.;.;.;.;.;.;x;x;_;_;
_;x;x;.;.;.;.;.;.;.;.;.;.;x;x;x;x;x;x;x;x;x;x;x;x;x;x;.;.;.;.;.;x;_;_;x;.;.;.;.;.;.;.;.;.;.;.;.;.;.;.;.;.;.;.;.;.;.;.;.;.;.;.;.;.;.;.;.;.;.;.;.;.;.;.;.;.;.;.;x;x;.;.;.;.;.;.;.;.;.;.;.;.;.;.;.;.;x;_;_;
_;_;x;x;x;.;.;.;.;.;.;.;.;x;x;x;_;_;x;x;x;.;x;x;_;_;x;x;.;.;.;.;x;x;_;x;x;.;.;.;.;.;.;.;x;x;.;.;.;.;.;.;.;.;.;.;.;.;.;.;.;.;.;.;.;.;.;.;.;.;.;.;.;.;.;.;.;.;x;x;x;.;.;.;.;.;.;.;.;.;.;.;.;r;.;.;.;x;_;_;
_;_;_;_;x;x;x;.;.;.;.;.;.;.;.;x;_;_;x;.;.;.;.;x;x;_;_;x;.;.;.;.;.;x;_;x;.;.;.;.;.;.;.;.;x;x;.;.;.;.;.;.;.;.;x;.;x;.;.;.;.;.;.;.;.;.;.;.;.;.;x;x;.;.;.;.;.;.;x;_;x;.;.;.;.;.;.;.;.;.;.;.;.;.;.;.;.;x;x;_;
_;_;_;_;_;_;x;x;x;.;.;.;.;.;.;x;_;_;x;.;.;.;.;.;x;_;x;x;.;.;.;.;.;x;_;x;x;x;.;.;.;.;.;x;x;x;x;.;.;.;.;.;x;x;x;x;x;.;x;.;x;x;.;.;.;.;.;.;.;.;.;x;.;x;.;.;.;x;x;x;x;x;.;.;.;.;.;.;.;.;.;.;.;.;.;.;.;.;x;_;
_;_;_;_;x;x;x;.;.;.;.;.;.;r;.;x;_;_;x;.;.;.;.;.;x;_;x;.;.;.;.;.;.;x;_;_;_;x;x;x;.;.;x;x;x;.;.;.;.;.;x;.;x;x;x;x;x;x;x;x;x;x;.;.;.;.;.;.;.;f;.;x;x;x;x;.;.;.;.;x;_;x;x;x;.;.;.;x;.;.;.;.;.;.;x;.;x;x;x;_;
_;_;_;x;x;.;.;.;.;.;.;.;.;.;.;x;_;_;x;.;.;.;.;.;x;_;x;.;.;.;.;.;x;x;_;_;_;_;_;x;x;x;x;x;x;.;.;.;x;.;x;x;x;x;.;.;.;.;x;x;_;x;.;.;.;.;.;.;.;.;.;.;x;x;x;.;.;.;x;x;_;_;_;x;x;x;.;.;.;.;.;.;.;.;.;.;x;_;_;_;
_;x;x;x;.;.;.;.;.;.;.;.;.;.;.;x;_;x;x;.;.;.;.;x;x;_;x;x;.;.;.;.;x;_;_;_;_;_;_;_;x;x;x;.;x;.;x;.;x;x;x;x;.;.;.;.;.;.;.;x;x;x;.;.;.;.;.;.;.;.;.;x;x;x;.;.;.;.;.;x;x;_;_;_;_;x;.;.;.;.;.;.;.;.;.;.;x;x;x;_;
x;x;.;.;.;.;.;.;.;.;.;.;.;.;.;x;x;x;.;.;.;.;.;x;x;_;x;.;.;.;.;x;x;_;x;x;x;x;x;_;x;.;.;.;.;.;x;x;x;x;x;.;.;.;.;.;.;.;.;.;x;x;.;.;.;.;.;.;.;.;.;.;.;.;.;.;.;.;.;.;x;_;_;_;_;x;.;f;.;.;.;.;.;.;.;.;.;.;x;_;
x;.;.;.;.;.;.;.;.;.;.;.;.;.;.;.;.;.;.;.;.;.;.;.;x;x;x;x;.;.;.;x;x;x;x;.;x;.;x;x;x;.;.;.;x;x;x;x;x;x;.;.;.;.;.;.;.;.;.;.;x;.;.;.;.;.;.;.;.;.;.;.;.;.;.;.;.;.;.;.;x;x;x;_;_;x;.;.;.;.;.;.;.;.;.;.;.;.;x;_;
x;.;.;.;.;.;.;.;.;.;.;.;.;.;.;x;x;.;.;.;.;.;.;.;.;.;.;.;.;x;x;x;x;.;x;.;x;x;x;x;.;.;.;x;x;x;x;.;.;.;.;.;.;.;.;.;.;.;.;.;.;.;.;.;.;.;.;.;.;.;.;.;.;.;.;.;.;.;.;.;.;.;x;_;_;x;.;.;.;.;.;.;.;.;.;.;.;.;x;_;
x;.;.;.;.;.;.;.;.;.;.;.;.;.;.;.;.;.;.;.;.;.;.;.;.;.;.;.;x;x;x;x;x;.;x;.;x;.;.;.;.;.;x;x;x;.;.;.;.;.;.;.;.;.;.;.;.;.;.;.;.;.;.;.;.;.;.;.;.;.;.;.;.;.;.;.;.;.;.;.;.;.;x;x;_;x;.;.;.;.;.;.;.;.;.;.;.;x;x;_;
x;x;.;.;.;.;.;.;.;.;.;.;.;x;x;x;x;.;.;.;.;.;.;.;.;.;.;.;x;_;x;.;.;.;x;.;x;.;.;.;r;.;x;x;.;.;.;.;.;.;.;.;m;.;.;.;.;.;.;.;.;.;.;.;.;.;.;.;.;.;.;.;.;.;x;.;.;.;.;.;.;.;.;x;_;x;x;.;.;.;.;.;x;x;.;x;x;x;_;_;
_;x;x;.;.;.;.;.;.;.;.;x;x;x;x;.;.;.;.;.;.;.;.;.;.;.;.;.;x;_;x;x;x;.;.;.;.;.;.;.;.;.;.;.;.;.;.;.;f;.;.;.;.;.;.;.;.;.;.;.;.;.;.;.;.;.;.;.;.;.;.;.;.;x;x;.;.;.;.;.;.;.;.;x;_;_;x;.;.;.;.;.;x;x;x;x;x;x;_;_;
_;_;x;.;.;.;.;.;.;.;x;.;.;.;.;.;.;.;.;.;.;.;.;.;.;.;.;x;x;x;_;_;x;.;.;.;.;.;.;.;.;.;.;.;.;.;.;.;.;.;.;.;.;.;.;.;.;.;.;.;.;.;.;.;.;.;.;.;.;.;.;.;.;.;x;.;.;.;.;.;.;.;.;x;_;_;x;.;.;.;.;.;.;.;.;.;.;x;x;x;
_;_;x;.;.;.;.;.;.;.;.;.;.;.;.;.;.;.;.;.;.;.;.;.;.;.;.;.;.;x;x;_;x;.;.;.;.;.;.;.;.;.;.;.;.;.;.;.;.;.;.;.;x;x;.;.;.;.;.;.;.;.;.;.;.;.;.;.;.;.;.;.;.;.;.;.;.;.;.;.;.;.;.;x;_;_;x;x;.;.;.;.;.;.;.;.;.;.;.;x;
_;_;x;.;.;.;.;.;x;.;.;.;.;.;.;.;.;.;.;.;.;.;.;.;.;.;.;.;x;.;x;x;x;.;.;.;.;m;.;.;.;.;.;.;.;.;.;.;.;.;x;x;x;.;.;.;.;.;.;.;.;.;.;.;.;.;.;.;.;.;.;.;.;.;.;.;.;.;.;.;.;.;.;x;_;_;_;x;.;.;.;.;.;.;.;.;.;.;.;x;
_;_;x;x;x;.;x;x;x;.;.;.;.;.;.;.;.;.;.;x;.;.;.;x;x;.;.;.;.;.;x;.;.;.;.;.;.;.;.;.;.;.;.;.;.;r;.;.;.;.;x;x;x;.;.;.;.;m;.;.;.;.;.;.;.;.;.;.;.;.;.;.;.;.;.;.;.;.;.;.;.;.;.;x;_;_;x;x;.;.;.;.;.;.;.;.;.;.;x;x;
_;_;_;_;x;x;x;_;x;x;.;.;.;.;.;.;r;.;.;x;x;x;x;x;x;.;.;.;.;.;.;.;.;.;.;.;.;.;.;.;.;.;.;.;.;.;.;.;.;.;x;x;.;.;.;.;.;.;.;.;.;.;.;.;.;.;r;.;.;.;.;.;.;.;.;.;.;.;.;.;.;.;.;x;_;x;x;.;.;.;.;.;.;.;.;.;.;.;x;_;
_;_;_;_;_;_;_;_;_;x;.;.;.;.;.;.;.;.;.;x;x;_;x;x;x;.;.;.;.;.;.;.;.;.;f;.;.;.;.;.;.;.;.;.;.;.;.;.;.;.;x;x;x;.;.;.;.;.;.;.;.;.;.;.;.;.;.;.;.;x;.;.;.;.;.;.;.;.;.;.;.;.;.;x;x;x;.;.;.;.;.;.;.;.;.;.;.;.;x;x;
_;_;_;_;_;_;_;_;x;x;.;.;.;.;.;.;.;.;.;.;x;x;x;.;.;.;.;.;.;.;.;.;.;.;.;.;.;.;.;.;.;.;.;.;.;.;.;.;.;.;x;x;x;.;.;.;.;.;.;.;.;.;.;.;.;.;.;.;.;.;.;.;.;x;.;.;.;.;.;.;.;.;x;x;x;.;.;.;.;m;.;.;.;.;.;.;.;.;.;x;
_;_;_;_;_;_;_;_;x;.;.;.;.;.;.;.;.;.;.;.;x;x;.;.;.;.;.;.;.;.;.;.;.;.;.;.;.;.;.;.;.;.;.;.;.;.;.;.;.;.;.;.;.;.;.;.;.;.;.;.;.;.;.;x;x;x;x;x;.;x;.;.;.;.;x;.;.;.;.;.;.;.;x;.;.;.;.;.;.;.;.;.;.;.;.;.;.;.;.;x;
_;_;_;_;_;_;_;x;x;.;.;.;.;.;.;.;.;.;.;.;x;x;.;.;.;.;.;.;.;.;.;.;.;.;.;.;.;.;.;.;.;.;.;r;.;.;.;.;.;.;.;f;.;.;.;.;.;.;.;.;.;.;.;.;.;.;.;.;x;x;.;.;.;x;.;.;.;.;.;.;.;x;x;.;.;.;.;.;.;.;.;.;.;.;.;.;.;.;.;x;
_;_;_;_;_;_;_;x;.;.;r;.;.;.;.;.;.;.;.;x;x;.;.;.;.;.;.;.;.;.;.;.;.;.;.;.;.;.;.;.;x;.;.;.;.;.;.;.;.;.;.;.;.;.;.;.;.;.;.;.;.;.;.;.;.;.;.;.;x;.;.;.;.;.;.;f;.;.;.;.;.;x;.;.;.;.;.;.;.;.;.;.;.;.;.;.;.;.;.;x;
_;_;_;_;_;_;_;x;.;.;.;.;.;.;.;.;.;.;x;x;x;.;.;.;.;.;.;.;.;x;x;x;.;.;.;.;.;.;.;x;x;x;.;.;.;.;.;.;.;.;.;.;.;.;.;.;.;.;.;.;.;.;.;.;.;.;.;.;.;.;x;x;x;.;.;.;.;.;.;.;.;.;.;.;.;.;.;.;.;.;.;.;.;.;.;.;.;x;.;x;
_;_;_;_;_;_;_;x;.;.;.;.;.;.;.;.;x;x;x;x;.;.;.;.;.;.;.;.;x;x;_;x;x;.;.;.;.;.;.;x;_;x;x;.;.;.;.;.;.;.;.;.;.;.;.;.;.;.;.;m;.;.;.;.;.;.;.;.;.;.;.;.;.;.;.;.;.;.;.;.;.;.;.;.;.;.;.;.;.;.;.;.;.;.;x;x;x;x;x;x;
_;_;_;_;_;_;_;x;.;.;.;.;.;.;.;x;x;x;x;x;x;.;.;.;.;.;.;.;x;_;_;_;x;x;.;.;.;.;.;x;_;_;x;x;x;x;x;x;.;.;.;.;.;.;.;.;.;.;.;.;.;.;.;.;.;.;.;.;.;.;.;x;x;.;.;.;.;.;.;.;.;.;.;.;.;.;.;.;.;.;x;x;x;.;x;_;_;_;_;_;
x;x;x;x;_;_;x;x;.;.;.;.;.;.;.;.;.;.;.;x;x;.;.;.;.;.;.;.;x;_;_;_;_;x;.;.;.;.;.;x;_;_;_;_;_;x;.;.;.;.;.;.;.;.;.;.;.;.;.;.;.;.;.;.;.;.;.;.;.;.;.;.;.;.;.;.;.;.;.;.;.;.;.;.;.;.;.;.;.;.;x;_;x;x;x;x;x;x;x;x;
x;.;.;x;_;x;x;.;.;.;.;.;.;x;x;x;.;.;.;.;.;x;.;.;.;.;.;.;x;_;_;_;_;x;x;.;.;.;x;x;_;_;_;_;x;x;.;.;x;x;x;.;.;.;.;.;.;.;.;.;.;.;.;.;.;.;.;.;.;.;.;.;.;.;.;.;.;.;.;.;.;.;.;.;.;.;.;.;.;.;x;_;_;x;x;x;.;x;.;x;
x;x;x;x;_;x;.;.;.;.;.;.;x;x;x;.;.;.;.;.;.;.;.;.;.;.;.;.;x;x;_;_;_;x;.;.;.;x;x;x;x;x;x;x;x;.;.;.;.;x;x;.;.;.;.;.;.;.;.;.;.;.;.;.;.;.;.;.;.;.;.;.;.;.;.;.;.;.;.;.;.;.;.;.;.;.;.;.;x;x;x;_;_;x;.;x;.;.;.;x;
_;_;_;_;x;x;.;.;.;.;.;x;x;_;x;.;.;.;.;.;.;.;.;.;.;.;.;.;.;x;x;_;_;x;x;.;.;.;.;.;.;.;.;x;x;x;.;.;x;x;x;.;.;.;.;.;.;.;.;.;.;.;.;.;.;.;.;.;.;.;.;.;.;.;.;.;.;.;.;x;x;.;.;.;.;.;x;x;x;x;x;x;_;x;.;.;.;.;.;x;
_;_;_;_;x;.;.;.;.;.;x;x;_;_;x;.;.;.;.;.;.;.;.;.;.;.;.;.;.;.;x;_;_;x;.;.;.;.;.;.;.;.;.;.;.;.;.;x;x;_;x;.;.;.;.;.;.;.;.;.;.;.;.;.;.;r;.;.;.;.;.;.;.;.;.;.;.;.;.;x;x;.;.;.;.;.;.;.;.;.;.;x;x;x;.;.;.;.;.;x;
_;_;_;_;x;x;.;.;.;x;x;_;_;x;x;.;.;.;.;.;.;.;.;.;.;.;.;.;.;.;x;_;_;x;x;.;.;.;.;.;.;.;.;.;.;.;.;x;x;_;x;.;.;.;.;.;.;.;.;.;.;.;.;.;.;.;.;.;.;.;.;.;.;.;.;.;.;.;.;x;.;.;.;.;.;.;.;.;.;.;.;.;x;x;x;.;.;.;.;x;
_;_;_;_;_;x;x;.;x;x;_;_;_;x;.;.;.;.;.;.;.;.;.;.;.;.;.;.;.;.;x;_;_;_;x;x;.;.;.;.;.;.;.;.;.;.;.;.;x;_;x;.;.;.;.;.;.;.;.;.;.;.;.;.;.;.;.;.;.;.;.;.;.;.;.;.;.;.;.;.;.;.;.;.;.;.;.;.;.;.;.;.;.;x;x;.;.;.;.;x;
_;_;_;_;_;_;x;x;x;x;x;_;x;x;.;.;.;.;.;.;.;.;.;.;.;.;.;.;.;x;x;_;_;_;_;x;x;.;.;.;.;.;.;.;.;.;.;.;x;x;x;x;.;.;.;.;.;.;x;.;x;.;.;.;.;.;.;.;.;.;.;.;.;.;.;.;.;.;.;.;.;.;.;.;.;.;.;.;.;.;.;.;.;x;x;.;.;.;.;x;
_;_;_;_;x;x;x;.;.;.;x;x;x;.;.;.;m;.;.;.;.;.;.;.;.;.;.;.;x;x;_;_;_;_;_;_;x;x;.;.;.;.;.;.;.;.;.;.;.;x;x;x;.;.;.;.;.;.;x;x;x;.;x;x;x;x;.;.;.;.;.;.;.;.;.;.;.;.;.;.;m;.;.;.;.;.;.;.;.;.;.;.;.;x;.;.;.;.;.;x;
_;_;_;_;x;.;.;.;.;.;.;x;x;.;.;.;.;.;.;.;.;.;.;.;x;x;.;x;x;_;_;_;_;_;_;x;x;x;.;.;.;.;.;.;.;.;.;.;.;.;x;x;x;.;.;.;.;x;x;_;x;x;x;_;_;x;.;.;.;f;.;.;.;x;x;x;.;.;.;.;.;.;.;.;.;.;.;.;.;.;.;.;.;.;.;.;.;.;.;x;
_;_;_;_;x;.;.;.;.;.;.;.;x;x;.;m;.;.;.;.;.;.;.;.;x;x;x;x;x;x;_;_;_;_;x;x;.;x;.;r;.;.;.;.;.;.;.;.;.;.;.;x;x;x;.;.;x;x;_;_;x;x;x;x;x;x;.;.;.;.;.;.;x;x;_;x;x;x;.;.;.;.;.;.;.;.;.;.;.;.;.;.;.;.;.;.;.;.;x;x;
_;_;_;_;x;.;.;.;.;.;.;.;x;x;.;.;.;.;.;.;.;.;.;.;x;x;x;x;.;x;x;x;_;x;x;.;.;.;.;.;.;.;.;.;.;.;.;.;.;.;.;x;x;x;x;x;.;x;x;x;x;.;.;.;.;.;.;.;.;.;.;.;x;x;x;x;_;x;x;.;.;.;.;.;.;.;.;.;.;.;.;.;.;.;.;.;.;.;.;x;
_;_;_;_;x;.;.;.;.;.;.;.;x;x;x;x;x;x;x;x;.;.;.;.;.;x;x;.;.;.;.;x;_;x;.;.;.;.;.;.;.;.;.;.;.;.;.;.;.;.;.;.;x;x;.;.;.;.;.;.;.;.;.;.;.;.;.;.;.;.;.;.;x;.;.;x;x;x;.;.;.;.;.;.;.;.;.;.;.;.;.;.;.;.;.;.;.;.;.;x;
_;x;x;x;x;.;.;.;.;.;.;.;x;x;.;.;x;_;x;.;.;.;.;.;.;.;.;.;.;.;.;x;x;x;.;.;.;.;.;.;.;.;.;.;.;.;.;.;.;.;.;.;.;.;.;f;.;.;.;.;.;.;.;.;.;.;.;.;.;.;.;x;x;.;.;.;x;.;.;.;.;.;.;.;.;.;.;.;.;.;.;.;.;.;.;.;.;.;.;x;
_;x;.;.;.;.;x;.;.;.;.;x;x;x;x;x;x;_;x;x;.;.;.;.;.;.;.;.;.;.;.;.;.;.;.;.;.;.;.;.;.;.;.;.;.;.;.;.;.;.;.;.;.;.;.;.;.;.;.;.;.;.;.;.;.;.;.;.;.;.;x;x;x;.;.;.;.;.;.;.;.;.;.;.;.;.;.;.;.;.;.;.;.;.;.;.;.;.;.;x;
x;x;.;.;.;.;x;.;.;.;.;x;x;_;_;_;_;_;_;x;.;.;.;.;.;.;.;.;.;.;.;.;.;.;.;.;.;.;.;.;.;.;.;.;.;.;.;.;.;.;.;.;.;.;.;.;.;.;.;.;.;.;.;.;.;.;.;.;.;.;x;_;x;.;f;.;.;.;.;.;.;.;.;.;.;.;.;.;.;.;.;.;.;.;.;.;.;.;.;x;
x;.;.;.;.;.;.;.;.;.;.;.;x;x;_;x;x;x;x;x;x;.;.;.;.;.;.;.;.;.;.;.;.;.;.;.;.;.;r;.;.;.;.;.;.;.;.;.;.;.;.;x;.;.;.;.;.;.;.;.;.;.;.;.;.;.;.;.;.;x;x;_;x;.;.;.;.;.;.;.;.;.;.;.;.;.;.;.;.;.;x;.;.;.;.;.;.;.;.;x;
x;x;.;.;.;.;.;.;.;.;.;.;.;x;_;x;.;.;.;.;.;.;.;.;.;.;x;.;.;.;.;.;.;.;.;.;.;.;.;.;.;.;.;.;x;.;.;.;.;.;.;.;.;.;.;.;.;.;.;.;x;.;.;.;.;.;.;.;x;x;_;_;x;.;.;.;.;.;.;.;.;.;.;.;.;.;.;.;.;x;x;.;.;.;.;.;.;.;.;x;
_;x;x;x;.;.;.;.;.;.;.;.;x;x;_;x;.;.;.;.;.;.;.;.;.;.;x;.;.;.;.;.;.;.;.;.;.;.;.;.;.;.;.;x;x;x;x;.;.;.;x;x;.;.;.;.;.;x;x;x;x;.;.;.;.;.;.;x;x;_;_;_;x;.;.;.;.;.;.;.;.;.;.;.;.;.;.;.;x;x;x;.;.;.;.;.;.;x;.;x;
_;_;_;x;x;x;.;.;.;.;.;.;x;_;_;x;.;.;.;.;.;.;.;.;x;x;x;x;x;.;x;.;x;.;x;x;x;.;.;.;.;.;.;x;_;_;x;x;x;.;.;x;.;x;.;x;x;x;_;_;x;.;x;.;.;.;x;x;_;_;_;_;x;.;.;.;.;.;.;.;.;x;x;.;.;.;x;x;x;_;x;.;.;.;.;.;x;x;x;x;
_;_;_;_;_;x;x;x;x;x;x;x;x;_;_;x;x;x;x;x;x;x;x;x;x;_;_;_;x;x;x;x;x;x;x;_;x;x;x;x;x;x;x;x;_;_;_;_;x;x;x;x;x;x;x;x;_;_;_;_;x;x;x;x;x;x;x;_;_;_;_;_;x;x;x;x;x;x;x;x;x;x;x;x;x;x;x;_;_;_;x;x;x;x;x;x;x;_;_;_;
