_;_;_;_;_;x;x;x;x;x;_;_;x;x;x;x;x;x;x;x;x;_;_;x;x;x;x;x;x;x;x;x;_;_;_;x;x;x;x;x;x;_;_;_;_;_;_;_;_;_;x;x;x;x;x;x;x;x;x;x;x;x;x;x;_;x;x;x;x;x;x;x;_;_;_;x;x;x;x;x;x;x;x;x;x;x;x;x;x;x;x;x;x;x;x;x;x;_;_;_;
_;_;_;_;_;x;.;x;.;x;_;_;x;.;.;.;.;.;.;.;x;x;x;x;.;.;.;.;.;.;.;x;x;x;_;x;.;.;.;.;x;_;_;_;_;_;_;_;x;x;x;.;.;.;.;.;.;x;.;.;.;.;.;x;x;x;.;.;.;.;.;x;x;x;x;x;.;.;.;.;.;.;.;x;.;.;.;.;.;.;.;.;.;.;.;.;x;x;_;_;
_;_;_;_;_;x;.;.;.;x;x;x;x;.;.;.;x;.;.;.;.;.;x;.;.;.;.;.;.;.;.;.;.;x;x;x;x;.;.;.;x;_;_;_;_;_;_;_;x;.;.;.;.;.;.;.;.;.;.;.;.;.;.;.;x;.;.;.;.;.;.;.;.;.;.;.;.;.;.;.;.;.;.;.;.;.;.;.;.;.;.;.;.;.;.;.;.;x;_;_;
_;_;_;_;_;x;.;.;.;.;.;.;.;.;.;.;.;.;.;.;.;.;x;.;.;.;.;.;.;.;.;.;.;.;.;x;x;.;x;x;x;_;_;_;_;_;_;_;x;x;.;.;.;.;.;.;.;.;r;.;.;.;.;.;.;.;.;.;.;.;.;.;.;.;.;.;.;.;.;.;.;.;f;.;.;.;.;.;.;.;.;.;.;.;.;.;.;x;x;x;
_;_;_;_;x;x;.;m;.;.;.;.;.;.;.;.;x;.;.;.;.;.;.;.;.;.;.;.;.;.;.;.;.;.;.;.;x;x;x;x;_;_;_;_;_;_;_;x;x;.;.;.;.;.;.;.;.;.;.;.;.;.;.;.;.;.;.;.;.;.;.;.;.;.;.;.;.;.;.;.;.;.;.;.;.;.;.;.;.;.;.;x;x;x;x;x;.;.;.;x;
_;_;_;_;x;.;.;.;.;.;.;.;.;.;.;.;.;.;.;.;.;.;.;.;x;.;.;.;.;.;.;.;.;.;.;.;.;.;.;x;x;x;_;_;_;x;x;x;.;.;.;.;.;.;.;.;.;.;.;.;.;.;.;.;.;.;.;.;.;.;p;.;.;.;.;.;.;.;.;.;.;.;.;.;.;.;.;.;.;.;.;.;.;.;.;.;.;x;x;x;
_;_;_;_;x;.;.;.;.;.;.;.;.;.;.;.;.;.;.;.;.;.;.;.;x;.;x;.;.;.;.;.;.;.;.;.;.;.;.;.;.;x;x;x;x;x;.;.;.;.;.;.;.;.;.;.;.;.;.;.;.;.;.;.;.;.;.;.;.;.;.;.;.;.;.;.;.;.;.;.;.;.;.;.;.;.;.;.;.;.;.;.;.;.;.;.;.;.;.;x;
_;_;_;_;x;.;.;.;.;.;.;.;.;.;.;.;.;.;.;.;.;r;.;.;x;x;.;.;.;.;.;.;.;.;.;.;.;.;.;.;.;.;x;x;.;.;.;.;.;.;.;.;.;.;.;.;m;.;.;.;.;.;.;.;.;.;.;.;.;.;.;r;.;.;.;.;.;.;x;x;.;x;x;.;.;.;.;.;.;.;.;.;.;.;.;.;.;.;x;x;
_;_;_;x;x;.;.;.;.;.;.;.;.;.;.;.;.;x;.;.;.;.;.;.;.;x;x;.;.;.;.;.;.;.;.;.;.;.;.;.;.;.;.;.;.;.;.;.;.;.;.;.;.;.;.;.;.;.;.;x;x;.;.;.;.;.;.;.;.;.;.;.;.;.;.;.;.;.;.;x;x;x;x;x;.;.;.;.;r;.;.;.;.;.;.;.;.;.;.;x;
_;x;x;x;.;.;.;.;.;.;.;.;.;.;.;.;.;.;.;.;.;.;.;.;.;.;.;.;.;.;.;.;x;x;.;.;.;.;.;.;.;.;.;.;.;.;.;.;.;.;.;.;.;.;.;.;.;.;x;x;x;x;x;.;.;.;.;m;.;.;.;.;.;.;.;.;.;.;.;.;.;.;.;x;x;x;.;.;.;.;.;.;.;.;.;.;.;.;.;x;
_;x;.;x;.;x;x;x;x;x;.;.;.;.;.;.;.;.;.;.;.;.;.;.;.;.;f;.;.;.;.;x;x;x;.;.;.;.;.;.;.;.;.;.;.;.;m;.;.;.;x;x;x;.;.;.;.;x;x;_;_;x;x;x;x;x;.;.;.;.;.;.;.;.;.;.;.;.;.;.;.;.;.;.;x;x;x;x;.;.;.;.;.;.;.;.;.;.;.;x;
x;x;.;.;.;x;_;x;x;.;.;.;.;.;.;.;.;.;.;.;.;.;.;.;.;.;.;.;.;.;.;.;x;x;.;.;.;.;.;.;.;.;.;.;.;.;.;.;.;x;x;x;.;.;.;.;x;x;_;_;x;x;.;x;x;x;.;.;.;.;.;.;.;.;.;.;.;.;.;.;.;.;.;.;.;x;_;x;x;x;x;x;x;.;.;.;.;.;.;x;
x;.;.;.;x;x;_;x;.;x;.;.;.;.;.;r;.;.;.;.;.;.;.;.;.;.;.;.;.;.;.;.;x;x;.;.;.;.;.;.;.;.;.;.;.;.;.;.;.;x;_;x;x;x;.;.;x;x;_;x;x;.;.;.;.;x;.;.;.;.;.;.;.;.;x;x;x;.;.;.;.;.;.;.;.;x;_;_;x;.;.;.;x;x;.;.;.;.;.;x;
x;.;.;.;.;x;_;x;.;.;.;.;.;.;.;.;.;.;.;.;.;x;.;.;x;.;.;.;.;.;.;.;.;.;.;.;.;.;.;.;.;.;.;.;.;.;.;.;.;x;x;_;x;.;.;.;.;x;x;x;.;.;.;.;.;.;.;.;.;.;.;.;.;.;.;.;.;.;.;.;.;.;.;.;x;x;_;x;x;x;.;.;.;x;x;.;.;.;.;x;
x;.;.;.;.;x;x;x;.;x;.;x;.;.;.;.;.;.;.;.;.;x;x;x;x;.;.;.;.;.;.;.;.;.;.;.;.;.;.;.;.;.;.;.;.;.;.;.;.;.;x;x;x;.;.;.;.;.;x;.;.;.;.;.;.;.;.;.;.;.;.;.;.;.;.;.;.;.;.;.;.;f;.;.;x;x;x;x;.;.;.;.;.;.;x;x;.;.;x;x;
x;.;.;.;.;.;x;x;x;x;x;x;x;x;x;.;.;.;.;.;.;x;_;_;x;.;.;.;.;.;.;.;.;.;.;.;.;.;.;.;.;.;.;.;.;.;.;.;.;.;x;x;.;.;.;.;.;.;.;.;.;.;.;.;.;.;.;.;.;.;.;.;.;.;.;.;.;.;.;.;.;.;.;.;.;.;.;.;.;.;.;.;.;.;.;x;x;.;.;x;
x;.;.;.;.;.;x;x;_;_;_;_;_;_;x;.;.;.;.;.;.;x;_;_;x;.;.;.;.;.;.;.;.;.;.;.;.;.;.;.;.;.;.;.;.;.;.;.;.;.;.;x;.;.;.;.;.;.;.;.;.;.;.;.;.;x;x;.;.;.;.;.;.;.;.;.;.;.;.;.;.;.;.;.;.;.;.;.;.;.;.;.;.;.;.;.;x;x;x;x;
x;x;.;.;.;.;.;x;x;x;_;_;x;x;x;.;.;.;.;.;.;x;_;_;x;x;.;.;.;.;.;.;.;x;.;x;x;.;.;.;.;.;.;.;.;.;.;.;.;.;x;x;x;.;.;.;r;.;.;.;.;.;.;.;.;.;x;.;.;.;.;.;.;.;.;.;.;.;.;.;.;.;.;.;.;.;.;.;.;.;.;.;.;.;.;.;.;x;_;_;
_;x;.;.;.;.;.;.;.;x;x;x;x;.;.;.;.;.;.;.;.;x;_;_;_;x;.;.;.;.;.;.;.;x;x;x;.;.;.;.;.;.;.;.;.;.;.;.;.;.;.;.;.;.;.;.;.;.;.;.;.;f;.;m;.;.;.;.;.;.;.;.;.;.;.;.;.;.;.;.;.;.;.;.;.;f;.;.;.;.;.;.;.;.;.;.;.;x;x;_;
x;x;.;.;.;.;.;.;.;.;.;.;.;.;.;.;.;.;.;.;.;x;_;_;_;x;x;.;.;.;.;.;.;x;x;x;.;.;.;.;r;.;.;.;.;.;.;.;.;.;.;.;.;.;.;.;.;.;.;.;.;.;.;.;.;.;.;.;.;.;.;.;.;.;.;.;.;.;.;.;.;.;.;.;.;.;.;.;.;.;.;.;.;.;.;.;.;.;x;_;
x;.;.;.;.;.;.;.;.;.;.;.;.;.;.;.;.;.;.;.;.;x;_;_;_;x;x;.;.;.;.;.;.;.;.;.;.;.;.;.;.;.;.;.;.;.;.;.;.;.;.;.;.;.;.;.;.;.;.;.;.;.;.;.;.;.;.;.;.;.;.;.;.;f;.;.;.;.;.;.;.;.;x;x;x;x;.;.;.;.;.;.;.;.;.;.;.;.;x;x;
x;.;.;.;.;.;.;.;.;.;.;.;.;.;.;.;.;.;.;.;.;x;_;_;x;x;.;.;.;.;.;.;.;.;.;.;.;.;.;.;.;.;.;.;.;.;.;.;.;.;.;.;.;.;.;.;.;.;.;.;.;.;.;.;.;.;.;.;.;.;.;.;.;.;.;.;.;.;.;.;x;.;x;_;_;x;x;.;.;.;.;.;.;.;.;.;.;.;.;x;
x;.;.;.;.;.;.;.;.;.;.;.;.;.;.;.;.;.;.;.;.;x;_;_;x;.;.;.;.;.;.;.;.;.;.;.;.;.;.;.;.;.;.;.;.;.;.;.;.;.;.;.;.;.;.;.;.;.;.;.;.;.;.;m;.;.;.;.;.;.;.;.;.;.;.;.;.;.;x;x;x;x;x;_;_;_;x;x;.;.;m;.;.;.;.;x;.;.;.;x;
x;.;.;.;.;.;.;.;.;.;.;.;.;.;.;.;.;.;.;.;.;x;x;_;x;.;.;.;.;.;.;.;.;.;.;.;.;.;.;.;.;.;.;.;.;.;.;.;.;.;.;.;.;.;.;.;.;m;.;.;.;.;.;.;.;.;.;.;.;.;.;.;.;.;.;.;.;.;x;_;_;_;_;_;_;_;_;x;.;.;.;.;.;.;.;x;x;x;.;x;
x;.;.;.;.;.;.;.;.;.;.;.;.;.;.;.;.;.;.;.;.;.;x;x;x;.;.;.;.;.;.;.;.;.;.;.;.;.;.;.;.;.;.;.;.;.;.;.;.;x;x;.;.;.;.;.;.;.;.;.;.;.;.;.;.;.;.;.;.;.;x;x;x;.;.;.;.;x;x;x;x;x;x;_;_;x;x;x;.;.;.;.;.;.;.;x;_;x;x;x;
x;x;.;.;.;.;.;.;.;.;.;.;.;.;.;.;.;.;.;.;.;.;.;x;.;.;.;.;r;.;.;.;.;.;.;.;.;.;.;.;.;.;.;.;.;.;.;.;.;x;x;.;.;.;.;.;.;.;.;.;.;.;.;.;.;.;.;.;.;.;x;x;x;x;x;.;x;x;x;.;.;.;x;x;_;x;.;.;.;.;.;.;.;.;.;x;x;_;_;_;
x;.;.;.;.;.;.;.;.;.;.;.;.;.;.;.;.;.;.;.;.;.;.;x;.;x;.;.;.;.;r;.;.;.;.;.;.;.;f;.;.;.;.;.;.;.;.;.;.;.;x;x;x;.;.;m;.;.;.;.;x;x;x;.;.;.;.;.;.;.;.;x;x;x;x;x;x;x;.;.;.;.;.;x;x;x;.;.;.;.;.;.;.;.;.;.;x;x;_;_;
x;x;.;.;.;.;.;.;.;m;.;.;.;x;.;x;.;x;.;.;.;.;.;.;.;.;.;.;.;.;.;.;.;.;.;.;.;.;.;.;.;x;.;.;.;.;.;.;.;.;.;.;.;.;.;.;.;.;.;.;.;x;x;.;.;.;.;.;.;.;.;.;.;x;x;x;x;x;.;.;.;.;.;.;.;.;.;.;.;.;.;.;.;.;.;.;.;x;x;x;
x;.;.;.;.;.;.;.;.;.;.;x;x;x;x;x;x;x;.;x;x;x;.;.;.;.;.;.;.;.;x;x;.;.;.;.;.;.;.;.;.;.;.;.;.;.;.;.;.;.;.;.;.;.;.;.;.;.;.;.;x;x;x;.;.;.;.;.;.;.;.;.;.;.;.;x;x;.;.;.;.;.;.;.;.;x;.;.;.;.;.;.;.;.;.;.;.;.;.;x;
x;x;.;.;.;.;x;x;.;.;.;.;.;x;x;_;_;x;x;x;x;.;.;.;.;.;.;.;.;.;.;x;.;.;.;f;.;.;.;.;.;.;.;.;.;.;.;.;.;.;.;.;.;.;.;.;.;.;.;.;.;x;x;x;x;.;.;.;.;.;.;.;.;.;.;x;x;.;.;.;.;.;.;.;.;.;.;.;.;x;x;x;x;.;.;.;.;.;.;x;
x;.;.;.;.;.;x;x;x;x;x;.;.;.;x;_;_;x;x;.;.;.;.;.;.;.;.;.;.;.;.;.;.;.;.;.;.;.;.;.;.;.;.;.;.;.;.;.;.;.;.;.;.;.;.;.;.;.;.;.;.;.;.;x;x;.;.;.;.;.;.;.;.;.;.;.;x;.;.;.;.;.;.;.;.;.;.;.;.;.;.;.;.;.;.;.;.;.;.;x;
x;x;.;.;.;.;x;x;x;.;.;.;.;.;x;_;x;x;.;.;.;.;.;x;x;x;.;.;.;.;.;.;.;.;.;.;.;x;.;.;.;.;.;.;.;.;.;.;.;.;.;.;.;.;.;.;.;.;.;.;.;.;.;.;.;.;.;.;.;.;.;.;.;.;.;x;x;.;.;.;.;.;.;.;.;.;.;.;.;.;.;.;.;.;.;.;.;.;.;x;
x;.;.;.;.;.;.;x;x;.;.;.;.;.;x;_;x;.;.;.;.;.;x;x;x;.;.;.;.;.;.;.;.;.;.;.;.;.;.;.;.;.;.;.;.;.;.;.;.;.;.;.;.;.;.;.;.;.;.;.;.;.;.;.;.;.;.;.;.;.;.;.;.;.;x;x;.;.;.;.;.;.;.;.;.;.;.;.;.;.;.;.;.;.;.;.;.;.;.;x;
x;.;.;.;.;.;.;.;.;.;.;.;.;.;x;x;x;.;.;.;.;.;.;x;x;.;.;.;.;.;.;.;.;.;.;.;.;.;.;.;.;.;.;.;.;.;.;.;.;.;.;.;.;.;x;.;.;.;.;.;.;.;.;.;.;.;.;.;.;.;.;.;.;x;x;x;x;.;.;.;.;.;.;.;.;.;.;.;.;.;.;.;.;.;.;.;.;.;.;x;
x;.;.;.;.;.;.;.;.;.;.;.;.;.;.;.;.;.;.;.;.;.;.;.;.;.;.;.;.;.;.;.;x;x;.;.;.;.;.;.;.;.;.;.;.;.;.;.;.;.;.;.;.;.;.;.;.;.;.;.;.;.;.;.;.;.;.;.;.;m;.;.;.;x;_;_;x;.;.;.;.;.;.;.;.;.;.;.;.;.;.;.;.;.;.;.;.;.;.;x;
x;.;.;.;.;.;.;.;.;.;.;.;.;.;.;.;.;.;.;.;.;.;.;.;.;.;.;.;.;.;.;.;x;x;.;.;.;.;.;.;.;.;.;.;.;.;.;.;.;.;.;.;.;.;x;.;.;.;.;.;.;.;.;.;.;.;.;.;.;.;.;.;.;x;x;x;x;.;.;.;.;.;.;.;.;.;.;.;.;.;.;.;.;.;.;.;.;.;.;x;
x;.;.;.;.;.;.;.;.;.;.;.;.;.;.;.;.;.;.;.;.;.;.;.;.;.;.;.;.;.;.;.;x;x;.;.;.;.;.;.;.;.;.;.;.;.;.;.;.;.;.;r;.;.;.;.;.;.;.;.;.;.;.;.;.;.;.;.;.;.;.;.;.;.;.;.;.;.;.;.;.;.;x;x;x;x;.;.;.;.;.;.;.;.;.;.;.;.;.;x;
x;.;.;.;.;.;.;.;.;.;.;.;.;.;.;.;.;.;.;.;.;.;.;.;.;.;.;.;.;.;.;.;x;x;.;.;.;.;.;.;.;.;.;.;.;.;.;.;.;.;.;.;.;x;.;.;.;.;.;.;.;.;.;.;.;.;.;.;.;.;.;.;.;.;.;.;.;.;.;.;.;x;x;x;x;x;.;.;.;.;.;.;.;.;.;.;.;.;.;x;
x;x;.;.;.;.;.;.;.;.;.;.;.;.;.;.;.;.;.;.;.;.;.;.;.;.;.;.;.;.;.;.;x;x;.;.;.;.;.;.;.;.;.;.;.;.;x;x;.;.;.;.;.;x;.;.;.;.;.;.;.;.;.;.;.;.;.;.;.;.;.;.;.;.;.;.;.;.;.;x;x;x;x;x;.;.;.;.;.;.;.;.;.;.;.;.;.;.;.;x;
x;.;.;.;.;.;.;.;.;.;.;.;.;.;.;.;.;.;.;.;.;.;.;x;x;.;.;.;.;.;.;.;x;x;x;.;.;.;.;.;.;.;.;.;.;x;x;x;x;x;x;x;x;x;x;x;.;x;.;.;.;.;.;.;x;x;x;.;.;.;.;.;x;x;.;.;.;.;.;x;x;x;x;.;.;.;.;.;.;.;.;.;.;.;.;.;.;.;.;x;
x;x;x;x;.;.;.;.;.;.;.;.;.;.;.;.;.;.;.;.;.;.;.;.;.;.;.;.;.;.;.;.;x;x;.;.;r;.;.;.;.;.;.;x;x;x;_;x;x;x;x;x;_;_;_;x;x;x;x;.;.;.;.;.;x;_;x;x;x;x;x;x;.;.;.;.;.;x;x;x;x;.;.;.;.;.;.;.;.;.;.;.;.;.;.;.;.;.;.;x;
_;_;_;x;x;.;.;.;.;.;.;x;.;.;.;.;.;x;.;.;.;.;.;.;.;.;.;.;.;.;.;.;x;x;.;.;.;.;.;.;.;x;x;x;x;x;x;x;.;.;.;x;x;x;_;_;_;_;x;.;.;.;.;.;x;x;x;.;.;.;.;.;.;x;.;x;.;x;x;.;.;.;.;.;.;.;.;.;.;.;.;.;.;.;.;.;.;.;.;x;
_;_;_;_;x;x;x;.;.;.;x;x;x;.;.;.;.;.;.;.;.;.;.;.;.;.;.;.;.;.;.;.;x;x;.;.;.;.;.;.;.;.;.;.;.;.;.;.;.;.;.;.;.;x;x;_;_;x;x;.;.;.;.;.;.;.;x;x;x;x;x;x;x;x;x;x;x;x;.;.;.;.;.;.;.;.;.;.;.;.;.;.;.;.;.;.;.;.;.;x;
_;_;_;_;x;x;x;.;.;.;.;x;x;x;.;.;.;.;.;.;.;.;.;.;.;.;.;.;.;.;.;.;.;x;.;.;.;.;.;.;.;.;.;.;.;.;.;.;.;.;.;.;.;.;x;_;x;x;.;.;.;.;.;.;.;.;x;.;.;.;.;.;x;_;x;x;x;.;.;.;.;.;.;.;.;.;.;.;.;.;.;.;.;.;.;.;.;.;.;x;
_;_;_;x;x;.;.;.;.;.;x;x;_;x;x;.;.;.;.;.;.;.;.;.;.;.;.;.;.;.;.;.;.;x;.;.;.;.;.;.;.;.;.;.;.;.;.;.;.;.;.;.;.;.;x;_;x;.;x;.;.;.;.;.;.;.;.;.;.;.;x;x;x;_;x;.;x;.;.;.;.;.;.;.;.;.;.;.;.;.;.;.;.;.;.;.;.;.;.;x;
_;x;x;x;.;.;.;.;.;.;.;x;x;x;x;.;.;.;.;.;.;.;.;.;.;.;.;.;.;.;.;.;.;x;.;.;.;.;.;.;.;.;.;.;.;.;.;.;.;.;.;.;.;.;x;_;x;.;.;.;.;.;.;.;.;.;.;.;.;.;.;x;_;x;x;.;.;.;.;.;.;.;.;.;.;.;.;.;.;.;.;.;.;.;.;.;.;.;.;x;
x;x;.;.;.;.;.;.;.;.;.;x;x;.;.;.;.;.;.;.;.;.;.;x;.;.;.;.;.;.;.;.;x;x;.;.;.;.;.;.;.;.;.;.;.;.;.;.;.;.;.;.;.;x;x;_;x;.;.;m;.;.;.;.;.;.;.;.;.;.;x;x;x;x;.;.;.;.;.;.;.;.;.;.;.;.;.;.;.;.;.;x;.;.;.;.;.;.;.;x;
x;.;.;.;.;.;.;.;.;.;.;.;.;.;.;.;.;.;.;.;.;.;.;x;x;.;f;.;.;.;.;.;.;x;.;.;.;.;.;x;x;.;.;.;.;.;.;.;.;.;.;.;.;.;x;x;x;.;.;.;.;.;.;.;.;.;.;.;.;.;.;.;x;x;.;.;.;.;.;.;.;.;.;.;x;.;.;.;.;.;.;.;.;.;.;.;.;.;x;x;
x;.;.;.;.;.;.;.;.;.;.;.;.;.;.;.;.;.;.;.;.;.;.;.;.;.;.;.;.;.;.;.;.;.;.;.;.;.;.;x;.;.;.;.;.;.;.;.;.;.;.;.;x;.;x;.;x;.;.;.;.;.;.;.;.;.;.;.;.;.;.;.;.;.;.;.;.;.;.;.;.;.;.;.;x;x;.;.;.;.;.;.;.;.;.;.;.;.;x;_;
x;.;.;.;.;.;.;.;.;x;.;.;.;.;.;.;.;.;.;.;.;.;.;.;.;.;.;.;.;.;.;.;.;.;.;.;.;.;.;x;x;.;.;.;.;.;.;.;.;.;.;.;.;.;.;.;.;.;.;.;.;.;.;.;.;.;.;.;.;.;.;.;.;.;.;.;.;.;.;.;.;.;.;.;.;.;.;.;.;.;.;.;.;.;.;.;.;.;x;_;
x;.;.;m;.;.;.;.;x;.;.;.;m;.;.;.;.;.;.;.;.;.;f;.;.;.;.;.;.;.;.;.;.;x;x;x;.;.;x;x;x;.;.;.;.;.;x;x;.;.;.;.;.;.;.;.;.;.;.;.;.;.;.;.;.;.;.;.;.;.;.;.;.;.;.;.;.;.;.;.;.;.;.;.;.;.;.;.;.;.;.;.;.;.;.;.;.;.;x;_;
x;.;.;.;.;.;.;x;x;x;x;.;.;.;.;.;.;.;.;.;.;.;.;.;.;.;.;.;.;.;.;x;x;x;.;.;.;.;x;x;x;.;.;.;.;.;x;x;.;.;r;.;.;.;.;.;.;.;.;.;.;.;.;.;.;.;.;.;.;.;.;.;.;.;.;.;.;.;.;.;.;.;.;.;.;.;.;.;.;.;.;.;.;.;.;.;.;.;x;_;
x;.;.;.;.;f;.;x;_;_;x;.;.;.;.;.;.;.;.;.;x;x;.;.;.;.;.;.;.;.;.;.;.;.;.;.;x;x;x;x;.;.;.;.;.;.;x;x;x;.;.;.;.;.;.;.;.;.;.;.;.;.;x;.;x;.;.;.;.;.;.;.;.;.;.;.;.;.;.;.;.;.;.;.;.;.;.;.;.;.;.;.;.;.;.;.;.;x;x;_;
x;.;.;.;.;.;.;x;_;_;x;x;x;.;.;.;.;.;.;.;.;x;.;.;.;.;.;.;.;.;.;.;.;.;.;.;x;_;_;x;x;.;.;.;.;x;x;x;x;.;.;.;.;.;.;.;.;.;.;.;.;.;.;.;.;.;.;.;.;.;.;.;.;.;.;.;.;.;.;.;.;.;.;.;.;.;.;.;.;.;.;.;.;.;.;.;.;.;x;_;
x;.;.;.;.;x;x;x;_;_;_;_;x;x;x;.;.;.;.;f;.;.;.;.;.;.;.;.;.;.;.;.;.;.;.;.;x;_;_;_;x;.;.;.;x;x;.;x;x;x;.;.;.;.;.;.;.;x;x;x;x;.;.;.;.;.;.;.;.;.;.;.;.;.;.;.;.;.;.;.;x;x;x;.;.;.;.;.;.;.;.;.;.;x;.;.;.;x;x;x;
x;x;x;x;x;x;x;_;_;_;_;_;_;_;x;.;.;.;.;.;.;.;.;.;.;.;.;.;.;.;.;.;.;.;.;x;x;_;_;x;x;x;.;.;x;.;.;.;.;x;x;.;.;.;.;.;.;.;x;_;x;.;f;.;.;.;.;.;.;.;.;.;.;.;x;x;x;x;x;x;x;_;x;x;.;.;.;.;.;.;.;.;.;x;.;x;.;.;.;x;
x;.;.;.;.;.;x;x;x;x;x;x;_;_;x;x;.;.;.;.;.;.;.;.;.;.;.;.;.;.;.;.;.;.;.;x;_;x;x;x;.;.;.;.;.;.;.;.;x;x;x;x;.;.;.;.;x;x;x;x;x;.;.;.;.;.;.;.;.;.;.;.;.;x;x;_;_;_;_;_;x;x;x;x;x;.;.;.;.;.;.;.;.;x;x;x;.;x;.;x;
x;x;.;.;.;.;.;.;.;x;.;x;x;x;_;x;.;.;.;.;.;.;.;.;.;.;.;.;.;.;.;.;.;.;x;x;x;x;.;.;.;.;m;.;f;.;.;.;x;_;_;x;.;.;.;.;.;x;x;.;.;.;.;.;.;.;.;.;.;.;.;.;.;x;_;_;_;_;_;x;x;.;.;.;x;x;x;.;.;.;.;.;x;x;x;x;.;x;.;x;
_;x;.;.;.;.;.;.;.;.;.;x;.;x;x;x;.;.;.;.;.;.;.;.;.;.;.;.;.;.;.;.;x;x;x;x;x;.;.;.;.;.;.;.;.;.;.;.;x;x;x;x;.;x;.;x;x;x;x;.;.;.;.;.;.;.;.;.;.;.;.;.;.;x;_;_;_;_;x;x;.;.;.;.;.;.;.;.;.;.;.;.;.;x;x;.;.;.;.;x;
_;x;x;.;.;.;.;.;.;.;.;x;.;x;.;.;.;.;.;f;.;.;.;.;.;.;.;.;.;.;.;.;x;_;_;x;.;.;.;.;.;.;.;.;.;.;.;.;.;.;.;.;.;.;.;.;.;x;.;.;.;.;.;.;x;x;.;.;.;.;.;.;.;x;_;_;_;_;x;.;.;.;.;.;.;.;.;.;.;.;.;.;.;.;.;.;.;m;.;x;
_;_;x;.;.;.;.;.;.;.;.;x;.;.;.;.;.;.;.;.;.;.;.;.;.;.;.;.;.;.;.;.;x;_;x;x;.;.;.;.;.;.;.;r;.;.;.;.;.;.;.;.;.;x;x;x;x;x;.;.;.;.;.;.;x;x;.;.;.;.;f;.;.;x;x;x;x;x;x;.;.;.;.;.;.;.;.;.;.;.;.;.;.;.;.;.;.;.;.;x;
_;_;x;x;.;.;.;.;.;.;.;.;.;.;.;.;.;.;.;.;.;.;.;.;.;.;.;.;.;.;.;.;x;x;x;.;.;.;.;.;.;.;.;.;.;.;.;.;.;.;.;.;x;x;.;.;.;x;.;.;.;.;.;.;x;.;x;.;.;.;.;.;.;x;.;.;x;.;x;.;x;.;.;.;.;.;.;.;x;x;.;.;.;.;.;.;.;.;.;x;
_;_;x;x;.;.;.;.;.;.;.;.;.;x;.;.;.;.;x;x;x;.;.;m;.;.;.;.;.;.;.;.;.;x;.;.;.;.;.;.;.;.;x;x;x;x;.;.;f;.;.;.;x;x;x;x;.;.;.;.;.;.;.;.;.;.;.;.;.;.;.;x;.;.;.;.;.;.;.;.;.;.;.;.;.;.;.;.;x;x;x;.;m;.;.;.;.;.;.;x;
_;x;x;.;.;.;.;.;.;.;.;f;.;.;x;x;.;x;x;_;x;x;.;.;.;.;.;.;.;.;.;.;.;x;.;.;.;.;.;.;.;x;x;x;.;.;.;.;.;.;.;.;x;x;.;.;.;.;.;.;.;.;.;.;.;.;.;x;x;x;x;x;.;.;.;.;.;.;.;.;.;.;.;.;.;.;.;.;x;x;x;.;.;.;.;.;.;.;.;x;
_;x;.;.;.;.;.;.;.;.;.;.;.;x;x;x;x;x;_;x;x;x;.;.;.;.;.;.;.;.;.;.;.;.;.;.;.;x;.;x;x;x;x;.;.;.;.;.;.;.;.;.;x;x;.;.;.;.;.;.;.;.;.;.;.;.;.;.;x;_;x;x;.;.;.;.;.;.;.;.;.;.;.;.;.;.;.;.;x;x;.;.;.;.;.;.;.;.;x;x;
_;x;.;.;.;.;x;.;.;.;.;.;.;x;x;x;_;_;x;x;.;.;.;.;.;.;.;x;x;.;.;.;.;.;.;x;.;x;x;x;_;x;.;.;.;.;.;.;.;.;.;.;x;.;.;.;.;.;.;.;.;.;.;.;.;.;.;x;x;x;x;.;.;.;.;.;.;.;.;.;.;.;.;.;.;.;.;.;x;x;.;.;.;.;.;.;.;x;x;_;
_;x;.;.;.;x;x;x;.;.;.;r;.;x;.;x;x;x;x;.;.;.;.;.;.;.;.;.;.;.;.;.;.;.;.;.;x;x;_;_;_;x;.;.;.;.;.;.;.;.;.;.;x;.;.;.;.;.;.;.;.;.;.;.;.;.;.;.;.;x;.;.;.;.;.;.;.;.;.;.;.;.;.;.;.;.;.;.;.;.;.;.;x;.;x;.;x;x;_;_;
_;x;x;x;.;x;x;.;.;.;.;.;.;x;.;.;.;x;.;.;.;.;.;.;.;.;.;.;.;.;.;.;.;.;.;x;x;_;_;_;_;x;.;.;.;.;.;.;.;.;.;.;.;.;.;m;.;.;.;.;r;.;.;.;.;.;.;.;.;.;.;.;.;.;.;.;.;.;.;.;.;.;.;.;.;.;.;.;.;.;.;x;x;x;x;.;x;_;_;_;
_;_;x;x;.;.;.;.;.;.;x;x;x;x;.;x;x;x;x;.;.;.;.;.;.;.;.;.;.;.;.;.;.;.;.;x;_;_;_;_;_;x;.;.;.;.;.;.;.;.;.;.;.;.;.;.;.;.;.;.;.;.;.;.;.;.;.;.;.;.;.;.;.;.;.;.;.;.;.;.;.;.;.;.;.;.;.;.;.;.;.;x;_;_;x;x;x;_;_;_;
_;_;x;.;.;.;.;.;.;.;x;_;_;x;x;x;_;x;x;.;.;.;.;.;.;.;.;.;.;.;.;.;x;.;x;x;_;_;_;_;x;x;x;.;.;m;.;.;.;.;.;.;.;.;.;.;.;.;.;.;.;.;.;.;.;.;.;.;.;.;.;.;.;.;.;.;.;.;x;x;x;x;.;r;.;m;.;.;.;.;.;x;x;_;_;_;_;_;_;_;
_;x;x;.;.;.;.;.;x;x;x;_;_;_;_;x;x;x;.;x;x;x;x;x;x;.;.;.;.;.;.;.;x;x;.;x;x;x;x;x;x;.;.;.;.;.;.;.;.;.;.;.;.;.;.;.;.;.;.;.;.;.;.;.;.;.;.;.;.;.;.;.;.;.;.;.;.;.;.;x;x;x;.;.;.;.;.;.;.;f;.;.;x;x;_;_;_;_;_;_;
_;x;.;.;.;.;.;.;.;x;_;_;_;x;x;x;.;.;.;.;.;x;x;_;x;.;.;.;.;.;.;.;.;.;.;.;.;x;.;.;.;.;.;x;x;.;.;.;.;.;r;.;.;.;.;.;.;.;.;.;.;.;.;.;.;.;.;.;.;.;.;.;.;.;.;.;.;.;.;.;.;.;.;.;.;.;.;.;.;.;.;.;.;x;_;_;_;_;_;_;
_;x;.;.;.;.;.;.;.;x;_;_;x;x;.;.;.;.;.;.;.;.;x;x;x;x;.;.;.;.;.;.;f;.;.;.;.;.;.;.;.;.;.;x;x;.;.;.;.;.;.;.;.;.;.;.;.;.;.;.;.;.;.;.;.;.;.;.;.;.;.;.;.;.;.;.;.;.;.;.;.;.;.;.;.;.;.;.;.;.;.;.;.;x;x;x;x;x;x;x;
_;x;.;.;.;.;.;.;.;x;_;x;x;.;.;.;.;.;.;.;.;.;.;.;x;x;x;.;.;.;.;.;.;.;.;.;.;.;.;.;.;.;.;x;x;x;.;.;.;.;.;.;.;.;.;.;.;.;.;.;.;.;.;.;.;.;.;.;.;r;.;.;.;x;.;.;.;.;.;.;.;.;.;.;.;.;.;.;m;.;.;.;.;.;x;x;.;.;.;x;
x;x;.;.;.;.;.;.;.;x;x;x;.;.;.;.;.;.;.;.;.;.;.;.;.;x;x;.;.;.;.;.;.;.;.;.;.;.;.;.;.;.;.;.;.;.;.;.;m;.;.;.;.;.;.;.;.;.;.;.;.;.;.;.;.;.;.;.;.;.;.;.;.;x;.;.;.;.;.;.;.;.;.;.;.;.;.;.;.;.;.;.;.;.;.;.;.;.;.;x;
x;.;.;.;.;.;.;.;.;.;.;.;.;.;m;.;.;.;.;.;.;.;.;.;.;.;.;.;.;.;.;.;.;.;.;.;.;x;.;.;.;.;.;.;.;.;.;.;.;.;.;.;.;.;.;.;m;.;.;.;.;.;.;.;.;.;.;.;.;.;.;.;x;x;x;.;.;.;.;.;.;.;.;.;.;.;.;.;.;.;.;.;.;.;.;.;.;.;.;x;
x;.;.;.;.;.;.;.;.;.;.;.;.;.;.;.;.;.;.;.;.;x;.;r;.;.;.;.;.;.;.;.;.;.;.;.;.;.;.;.;.;.;.;.;.;.;.;.;.;.;.;.;.;.;.;.;.;.;.;.;.;.;.;.;.;.;.;x;x;.;x;.;x;x;x;.;.;.;.;.;.;.;.;x;x;.;.;.;.;r;.;.;.;.;.;.;.;.;.;x;
x;.;.;.;.;.;.;.;.;.;.;.;.;.;.;.;.;.;.;x;.;x;.;.;.;.;.;.;.;.;.;.;.;x;.;.;.;.;.;.;.;.;.;.;.;.;.;.;.;.;.;.;.;.;.;.;.;.;.;.;r;.;.;.;.;.;x;x;x;x;x;x;x;.;.;.;.;.;.;.;x;x;x;x;x;.;.;.;.;.;.;.;.;.;.;.;.;.;.;x;
x;.;.;.;.;x;x;x;.;.;.;.;.;.;.;.;.;.;x;x;x;x;x;.;.;.;.;.;.;.;.;x;x;x;x;.;.;.;.;.;.;.;.;.;.;.;.;.;.;.;.;.;.;.;.;.;.;.;.;.;.;.;.;.;.;.;x;_;_;_;_;_;x;x;.;.;.;.;.;.;x;_;_;_;x;.;.;.;.;.;.;.;.;.;.;.;.;.;.;x;
x;.;.;.;x;x;x;x;x;.;.;.;.;.;.;.;.;.;x;_;_;x;x;.;.;.;.;.;.;.;.;x;_;_;x;.;.;.;.;.;.;.;.;.;.;.;.;.;.;.;.;.;.;.;.;.;x;.;.;.;.;.;.;.;.;x;x;_;_;_;_;_;x;.;.;.;.;.;.;.;x;x;x;x;x;.;.;.;.;.;.;.;.;.;.;.;.;.;.;x;
x;x;.;.;x;.;x;.;x;.;.;.;.;.;.;.;.;.;x;_;x;x;.;.;.;.;.;.;.;.;.;x;_;_;x;x;x;.;.;.;.;.;.;.;.;.;.;.;.;.;.;.;.;x;x;x;x;.;.;.;.;.;.;x;x;x;_;_;_;_;_;_;x;x;.;.;.;.;.;x;.;x;.;.;.;.;.;.;.;.;.;.;.;.;.;.;.;.;.;x;
_;x;x;.;x;.;x;.;x;x;x;.;.;.;.;.;.;x;x;_;x;.;.;.;.;.;.;.;.;.;.;x;x;_;_;_;x;x;.;.;.;.;.;.;.;.;x;x;x;.;.;.;.;x;_;x;x;.;.;.;.;x;x;x;_;_;_;_;_;_;_;_;x;x;x;.;.;x;.;.;.;.;.;.;.;.;.;.;.;.;.;.;.;.;.;.;.;.;.;x;
x;x;x;.;.;.;x;.;x;_;x;x;x;.;.;.;.;x;_;_;x;x;.;.;.;.;.;.;.;.;.;.;x;_;_;_;x;x;.;.;.;.;.;.;.;.;.;.;.;.;.;.;.;x;x;x;.;.;.;x;x;x;_;_;_;_;_;_;_;_;x;x;x;.;x;x;x;x;x;.;.;.;.;.;.;.;.;.;.;.;.;.;.;.;.;.;.;.;.;x;
x;.;.;.;.;.;.;.;x;x;x;x;x;.;x;.;x;x;_;_;_;x;.;.;.;.;.;.;.;.;x;x;x;_;_;_;x;.;.;.;.;.;.;.;.;.;.;.;.;.;.;.;.;x;x;.;.;.;.;x;x;_;_;_;_;_;_;_;_;_;x;.;.;.;.;x;x;_;x;.;.;.;.;.;.;.;.;.;.;.;x;x;x;x;.;.;.;.;.;x;
x;.;.;.;.;.;.;.;.;x;.;x;x;.;.;.;.;x;_;_;_;x;x;x;.;.;.;.;.;.;x;_;_;_;_;_;x;.;.;.;.;.;.;.;.;.;.;.;.;.;.;.;x;x;x;.;.;.;.;.;x;_;_;_;_;_;_;_;_;x;x;.;.;.;.;.;x;x;x;.;.;.;x;.;.;.;.;.;.;.;x;_;x;x;.;.;.;.;.;x;
x;.;.;.;m;.;.;.;.;.;.;.;.;.;.;.;x;x;_;_;_;_;x;x;x;.;.;.;.;.;x;_;_;_;_;x;x;.;.;.;.;.;x;x;.;.;.;.;.;.;.;x;x;.;x;.;.;.;.;.;x;x;_;_;_;_;_;_;_;x;.;.;.;.;.;.;x;.;x;.;.;.;.;.;.;.;.;.;.;.;x;x;x;.;.;.;.;r;.;x;
x;x;.;.;.;.;.;.;.;.;.;.;.;.;.;.;.;x;_;_;_;_;x;.;.;.;.;.;.;.;x;x;x;x;x;x;.;.;.;.;.;x;x;.;.;.;.;.;.;x;x;x;x;x;x;.;.;.;.;.;.;x;_;_;_;_;_;_;_;x;.;.;.;.;.;.;.;.;.;.;.;.;.;.;.;.;.;.;.;.;.;x;x;x;x;.;.;.;.;x;
_;x;.;.;.;.;.;.;.;.;.;.;.;.;.;.;.;x;_;_;_;x;x;.;.;.;.;.;.;.;x;x;.;.;.;.;x;.;.;.;.;.;x;.;.;.;.;x;x;x;_;x;x;x;.;.;.;.;r;.;.;x;_;_;_;_;_;_;_;x;.;.;.;.;.;.;.;.;.;.;.;.;.;.;.;.;.;.;.;.;.;x;x;x;x;.;.;.;.;x;
_;x;x;x;x;x;x;x;x;.;.;.;.;.;.;.;.;x;_;_;_;x;.;.;.;.;.;.;.;.;.;.;.;.;.;.;.;.;.;.;x;x;x;.;.;.;.;.;x;_;x;x;.;.;.;.;.;.;.;.;.;x;x;x;x;x;_;_;_;x;x;.;.;.;.;.;.;.;f;.;.;.;.;.;.;.;.;.;.;x;.;.;.;x;x;x;x;x;x;x;
_;_;_;x;x;x;_;x;.;.;.;.;.;.;.;.;.;x;x;_;_;x;x;x;.;.;.;.;.;.;.;.;.;.;.;.;.;.;x;.;x;_;x;.;.;.;.;.;x;x;x;.;.;.;.;.;.;.;.;.;.;.;x;x;.;x;x;x;x;x;x;x;x;.;.;.;.;.;.;.;.;.;.;.;.;.;.;.;.;.;x;.;x;x;_;_;_;_;_;_;
_;x;x;x;.;x;x;x;x;.;.;.;.;.;.;.;.;.;x;_;_;_;_;x;x;.;.;.;.;.;.;.;.;.;.;.;.;.;x;x;x;_;x;.;.;.;.;.;.;x;.;.;.;.;.;.;.;.;.;.;.;.;.;.;.;.;.;.;.;.;x;x;x;.;.;.;.;.;.;.;.;.;.;.;.;.;.;.;.;.;x;.;x;_;_;_;_;_;_;_;
x;x;.;.;.;.;.;.;.;.;.;.;.;.;.;.;x;x;x;x;_;_;_;_;x;.;.;.;.;.;.;.;.;.;.;.;.;x;x;x;x;x;x;.;f;.;.;.;.;x;.;.;.;.;.;.;.;.;.;.;.;.;.;.;.;.;.;.;.;.;.;.;x;.;.;.;.;.;x;.;.;.;.;.;.;.;.;.;.;.;x;x;x;_;_;_;_;_;_;_;
x;.;.;.;.;.;.;.;.;.;.;.;x;x;x;x;.;.;.;x;_;x;x;x;x;.;.;.;.;.;.;.;.;.;.;.;.;.;x;x;.;x;.;.;.;.;.;.;.;.;.;.;.;.;.;x;x;.;.;.;.;.;.;.;.;.;.;.;m;.;.;.;.;x;.;.;.;.;x;x;.;.;.;.;.;.;.;.;.;.;.;x;_;_;_;_;_;_;_;_;
x;.;.;.;.;.;.;.;.;.;.;.;x;_;x;x;x;.;x;x;x;x;.;.;.;.;.;.;.;.;.;.;.;.;.;.;.;.;x;x;.;.;.;.;.;.;.;.;.;.;.;.;.;.;x;x;.;.;.;.;.;.;.;.;.;.;.;.;.;.;.;.;.;.;.;.;.;.;x;x;x;.;.;.;.;.;.;.;.;.;x;x;x;x;x;x;x;_;_;_;
x;.;.;.;.;.;.;.;.;.;.;.;x;x;x;.;.;.;.;.;x;.;.;.;.;.;.;.;.;.;r;.;.;.;.;.;.;x;.;.;.;r;.;.;.;.;.;.;.;.;.;.;.;.;.;.;.;.;.;.;.;.;.;.;.;.;.;.;.;.;.;.;.;.;.;.;.;.;.;x;x;.;.;.;.;.;.;.;.;.;.;.;x;x;.;.;x;_;_;_;
x;.;.;.;.;.;.;.;.;.;.;.;.;x;x;.;x;.;x;.;.;.;.;.;.;.;.;.;.;.;.;.;.;.;.;.;x;x;.;.;.;.;.;.;.;.;.;.;.;.;.;.;x;.;x;.;r;.;.;.;.;.;.;.;.;.;.;.;.;.;.;.;.;.;0;.;.;.;x;x;x;x;.;.;.;.;.;.;.;.;.;.;.;.;.;.;x;x;x;_;
x;.;.;.;.;.;.;.;.;.;.;.;.;x;x;x;x;.;x;.;.;.;.;.;.;.;.;.;.;.;.;.;.;.;x;.;x;.;.;.;.;.;.;.;.;.;.;.;.;.;.;.;x;x;x;.;.;.;.;.;.;.;.;.;.;.;.;.;.;.;x;x;x;.;.;.;.;.;.;x;x;.;.;.;.;.;.;.;.;.;.;.;.;.;.;.;.;.;x;_;
x;.;.;.;.;.;.;.;.;.;.;.;.;x;_;_;x;.;x;.;.;.;.;.;.;.;.;.;.;.;.;.;.;.;.;x;x;.;.;.;.;.;.;.;.;.;.;.;.;.;x;x;x;_;x;x;.;.;.;.;.;.;.;.;.;.;.;.;.;x;x;_;x;.;.;.;.;.;.;x;x;x;x;.;.;.;.;.;.;.;.;.;.;.;.;.;.;x;x;_;
x;x;.;.;.;.;.;.;.;.;.;x;.;x;_;_;x;x;x;.;.;.;.;.;.;.;.;.;.;.;.;.;.;x;x;x;.;.;.;.;.;.;.;.;.;.;x;.;x;x;x;_;_;_;_;x;.;.;.;.;.;.;.;.;.;.;.;.;x;x;_;_;x;x;.;.;.;x;.;x;_;_;x;.;.;.;x;x;.;.;.;.;.;.;.;.;.;x;_;_;
_;x;x;x;x;x;x;x;x;x;x;x;x;x;_;_;_;_;x;x;x;x;x;x;x;x;x;x;x;x;x;x;x;x;_;x;x;x;x;x;x;x;x;x;x;x;x;x;x;_;_;_;_;_;_;x;x;x;x;x;x;x;x;x;x;x;x;x;x;_;_;_;_;x;x;x;x;x;x;x;_;_;x;x;x;x;x;x;x;x;x;x;x;x;x;x;x;x;_;_;
