_;x;x;x;x;x;x;x;x;x;x;x;x;x;_;x;x;x;x;x;x;x;_;_;x;x;x;x;x;x;x;x;x;x;x;x;x;x;_;x;x;x;x;x;x;x;x;x;x;x;x;x;x;x;x;x;x;x;x;x;x;x;x;x;x;x;x;x;x;x;x;x;x;x;x;x;x;x;x;x;x;x;x;x;x;x;x;x;_;_;x;x;x;_;_;_;_;_;_;_;
x;x;.;.;.;.;.;x;.;.;.;.;.;x;_;x;.;.;.;.;.;x;x;_;x;.;.;.;.;.;.;x;x;.;.;.;.;x;x;x;.;.;.;.;.;.;.;.;.;.;.;.;.;.;.;.;.;.;.;.;.;.;.;.;.;.;.;.;.;.;.;.;.;.;.;x;.;.;.;.;.;.;.;.;.;.;.;x;x;_;x;.;x;x;x;_;_;_;_;_;
x;.;.;.;.;.;.;x;x;x;x;x;x;x;x;x;.;.;.;.;.;.;x;x;x;.;.;.;.;.;.;.;.;.;.;.;.;.;x;x;.;.;.;.;.;.;.;.;.;.;.;.;.;.;.;.;.;.;.;.;.;.;.;.;.;.;.;.;.;.;.;.;.;.;.;.;.;.;.;.;.;.;.;.;.;.;.;.;x;x;x;.;.;.;x;_;_;_;_;_;
x;x;.;.;.;.;.;.;.;.;.;.;.;x;x;.;.;.;.;.;.;.;x;x;.;.;.;.;.;.;.;.;.;.;.;.;.;.;.;x;x;.;.;.;.;.;.;.;.;.;.;.;.;.;.;.;.;.;.;.;.;.;.;.;.;.;.;.;.;.;.;.;.;.;.;.;.;.;.;.;.;.;.;.;.;.;.;.;x;x;.;.;.;.;x;_;_;_;_;_;
_;x;x;.;.;.;.;.;x;.;x;x;x;x;x;.;.;.;.;.;.;.;x;x;.;.;.;.;.;.;.;.;.;.;.;.;.;.;.;x;x;x;x;.;.;.;.;.;.;.;.;r;.;.;.;.;.;.;.;.;.;.;.;.;.;.;.;.;.;.;.;.;.;.;.;x;x;.;.;.;.;.;.;.;.;.;.;.;.;x;x;.;f;.;x;_;x;x;x;_;
x;x;.;.;.;.;.;.;.;.;.;.;.;.;x;.;.;.;.;.;.;x;x;x;.;.;.;.;.;.;.;.;.;.;.;.;.;.;.;.;x;_;x;x;x;.;.;.;.;.;.;.;.;.;.;.;.;.;.;.;.;.;.;.;.;.;.;.;.;.;.;.;.;.;.;x;x;x;.;.;.;.;.;.;.;.;.;.;x;x;.;.;.;.;x;_;x;.;x;x;
x;.;.;.;.;.;.;.;.;.;.;.;.;.;.;.;x;.;x;.;.;x;_;x;x;.;.;.;.;.;.;.;.;.;.;.;.;.;.;.;x;x;_;_;x;x;x;x;x;.;.;.;.;.;.;.;.;.;.;.;x;.;.;.;.;.;.;.;.;.;.;.;.;x;x;x;_;x;x;.;.;.;.;.;.;.;.;.;x;x;.;.;.;.;x;x;x;.;.;x;
x;.;.;.;.;.;.;.;.;.;f;.;.;.;x;x;x;x;x;x;x;x;_;_;x;.;.;.;.;.;.;.;.;.;.;.;.;.;.;.;.;x;x;x;x;x;_;_;x;x;.;.;.;.;.;.;.;.;.;x;x;x;.;.;.;.;.;.;.;.;.;.;.;x;.;x;x;x;.;.;.;.;.;.;.;.;.;.;x;.;.;.;.;.;x;x;.;.;.;x;
x;.;.;.;.;.;.;.;.;.;.;.;.;.;x;_;_;_;_;_;_;_;_;_;x;x;x;.;.;.;.;.;m;.;.;.;.;.;.;.;.;.;x;.;.;x;x;x;x;.;.;.;.;.;.;.;.;.;.;.;.;.;x;x;x;.;.;.;.;.;.;x;.;x;x;x;x;.;.;.;.;.;.;.;.;.;.;x;x;.;.;.;.;.;.;.;.;.;.;x;
x;.;.;.;.;.;.;.;.;.;.;.;.;.;x;x;_;x;x;x;_;_;_;_;_;_;x;x;x;x;.;.;.;.;.;.;.;.;.;.;.;.;x;x;x;x;x;.;.;.;.;.;.;.;.;.;.;.;.;.;.;.;.;.;x;x;.;.;.;.;x;x;.;x;x;_;x;.;.;.;.;.;.;.;.;.;.;x;x;.;.;.;.;.;.;.;.;.;.;x;
x;.;.;.;.;.;.;.;.;.;.;.;.;.;.;x;x;x;.;x;_;_;_;_;_;_;_;_;x;x;x;.;.;.;.;.;.;.;.;.;.;.;.;.;.;.;.;.;.;.;.;.;.;.;.;.;.;.;.;.;.;.;.;x;x;x;.;.;.;.;x;.;x;.;x;x;x;.;.;.;.;.;.;.;.;.;.;x;x;.;.;.;.;.;.;.;.;.;.;x;
x;.;.;.;.;.;.;.;.;.;.;.;.;.;.;.;.;.;.;x;x;x;_;_;_;_;_;_;x;.;.;.;.;.;.;.;.;.;.;.;.;.;x;.;.;.;.;.;.;.;.;.;.;.;.;.;.;.;.;.;.;.;.;x;_;x;x;.;x;.;x;.;.;.;.;.;x;.;.;.;.;.;.;.;.;.;.;x;x;x;.;.;.;.;.;.;.;.;.;x;
x;.;.;.;.;.;.;f;.;.;.;.;.;.;.;.;.;.;.;.;.;x;x;x;_;_;_;x;x;x;.;.;.;.;.;.;.;.;.;.;.;.;.;.;.;.;.;.;.;x;x;x;x;x;.;.;.;.;.;.;.;x;x;x;_;_;x;.;.;.;.;.;.;.;.;.;x;.;.;.;.;.;.;.;.;.;.;.;.;.;.;.;.;.;.;.;.;.;.;x;
x;.;.;.;.;.;.;.;.;.;.;.;.;.;.;.;.;.;.;.;.;.;.;x;x;x;_;x;.;.;.;.;.;.;.;.;.;.;.;.;.;.;.;.;.;.;.;.;x;x;_;_;_;x;.;.;m;.;.;.;x;x;_;_;_;_;x;.;.;.;.;.;.;.;.;.;.;.;.;.;.;.;.;.;.;.;.;.;.;.;.;.;.;.;.;.;.;.;x;x;
x;.;.;.;.;.;.;.;.;.;.;x;x;.;.;.;.;.;.;.;.;.;.;.;.;x;x;x;x;.;.;.;.;.;.;.;.;.;.;.;.;.;.;.;.;.;.;x;x;x;x;_;_;x;.;.;.;.;.;x;x;_;_;_;_;_;x;.;.;.;.;.;.;.;.;.;.;.;.;.;.;.;.;r;.;.;.;.;.;r;.;.;.;.;.;.;.;x;x;_;
x;.;.;.;.;.;.;.;.;.;.;.;.;.;.;.;.;.;.;.;.;.;.;.;.;.;.;x;.;.;.;.;.;.;.;.;.;.;.;.;.;.;.;.;.;.;x;x;x;.;x;x;_;x;.;.;.;.;.;x;_;_;_;_;_;_;x;.;.;.;.;.;.;.;.;.;.;.;.;.;.;.;.;.;.;.;.;.;.;.;.;.;.;.;.;.;.;.;x;x;
x;.;.;.;.;x;x;x;x;x;x;x;x;.;.;.;.;.;.;.;m;.;.;.;.;.;.;.;.;.;.;.;.;.;.;.;.;.;.;.;.;.;.;.;.;.;.;.;.;.;.;x;_;x;.;.;.;.;x;x;_;x;x;x;x;x;x;.;.;.;.;.;.;.;.;.;.;.;.;.;.;.;.;.;.;.;.;.;.;.;.;f;.;.;.;.;.;.;.;x;
x;.;.;.;.;x;_;_;_;_;x;.;x;x;.;.;.;.;.;.;.;.;.;.;.;.;.;.;.;.;.;.;.;.;.;.;.;.;.;.;.;.;.;.;.;x;x;.;.;.;.;x;_;x;.;.;.;x;x;x;x;x;.;.;.;.;x;.;.;.;.;.;x;x;x;.;.;.;.;.;.;.;.;.;.;.;.;.;.;.;.;.;.;.;.;.;.;.;.;x;
x;.;.;.;.;x;_;_;_;_;x;x;x;x;.;.;.;.;.;.;.;.;.;.;.;.;.;.;.;.;.;.;.;.;.;.;.;.;.;.;.;x;.;.;.;.;.;.;.;.;.;x;_;x;.;x;x;x;_;x;.;.;.;.;.;.;.;.;.;.;x;x;x;.;.;.;x;.;.;.;.;.;.;.;.;.;.;.;.;.;.;.;.;.;.;.;.;.;.;x;
x;.;.;.;.;x;_;_;_;_;_;_;x;.;.;.;.;.;.;.;x;x;.;.;.;.;.;.;f;.;.;.;.;.;.;x;.;x;.;x;.;x;x;.;.;.;x;.;.;.;.;x;x;x;x;x;_;_;x;x;.;.;.;.;.;.;.;.;x;x;x;_;x;x;x;.;.;.;.;.;.;.;.;.;.;.;.;.;.;.;.;.;x;x;.;.;.;.;.;x;
x;.;.;.;.;x;x;x;x;x;_;x;x;.;.;.;.;.;.;.;x;.;.;.;.;.;.;.;.;.;.;.;.;.;x;x;x;x;.;x;x;x;.;.;.;.;.;.;.;.;.;.;x;x;_;_;_;x;x;.;.;.;.;.;.;.;.;.;x;_;_;_;_;_;x;.;x;x;x;.;.;.;.;.;.;.;.;.;.;.;.;x;x;x;.;.;.;.;.;x;
x;.;.;.;.;.;x;.;.;x;x;x;.;.;.;.;.;.;.;.;.;.;.;.;.;.;.;.;.;.;.;.;.;.;x;x;x;x;x;x;_;x;.;.;.;.;x;x;x;.;.;.;.;x;_;x;x;x;.;.;.;.;.;.;.;.;.;.;x;x;x;x;_;_;x;x;x;_;x;x;.;.;.;.;.;.;.;.;.;.;.;x;_;x;.;.;.;x;x;x;
x;.;.;.;.;.;.;.;.;.;.;.;.;.;.;x;.;.;.;.;.;.;.;.;.;.;.;.;.;.;.;.;.;.;.;.;x;_;_;_;x;x;.;m;.;.;x;x;.;.;.;.;.;x;x;x;.;.;.;.;.;.;.;.;.;.;.;.;.;.;.;x;x;_;_;_;_;_;_;x;x;x;.;.;.;.;.;.;.;.;.;x;x;x;.;x;.;x;_;_;
x;.;.;.;.;.;.;.;.;.;.;.;.;.;.;.;x;x;x;.;.;.;.;.;.;.;.;.;.;.;.;.;.;.;.;x;x;_;_;_;x;.;.;.;.;.;x;x;.;.;.;.;.;.;.;.;.;.;.;r;.;.;.;.;.;.;.;.;.;f;.;.;x;x;_;_;_;_;_;_;_;x;x;x;.;.;.;.;.;.;.;.;.;.;.;.;x;x;x;_;
x;.;.;.;.;.;.;.;.;.;.;.;.;.;.;.;.;.;x;x;.;.;.;.;.;.;.;.;.;.;.;.;.;.;.;.;x;_;_;_;x;.;.;.;.;.;x;x;.;.;.;.;.;.;.;.;.;.;.;.;.;.;.;.;.;.;.;.;.;.;.;.;.;x;x;_;_;x;x;x;x;_;_;x;x;.;.;.;.;.;.;.;x;.;.;.;.;.;x;x;
x;.;.;.;.;.;.;.;.;.;.;.;.;.;.;.;.;.;.;x;.;.;.;.;.;.;.;.;.;.;.;.;.;.;x;x;x;_;_;_;x;.;.;.;.;x;x;x;.;.;.;.;.;.;.;.;.;.;.;.;.;.;x;.;x;.;.;.;.;.;.;.;.;.;x;x;_;x;.;.;x;_;_;_;x;x;x;.;.;.;x;x;x;.;.;.;.;.;.;x;
x;.;.;.;x;x;.;.;.;.;.;.;.;.;.;.;.;.;.;.;.;.;.;.;.;.;.;x;x;x;x;x;x;.;x;_;_;x;x;x;x;x;x;.;x;x;_;x;.;.;.;.;.;.;.;.;.;.;.;.;.;.;.;.;.;.;.;.;.;.;.;.;.;.;.;x;_;x;x;.;x;x;x;x;x;_;x;x;x;x;x;_;x;x;x;.;.;.;.;x;
x;.;.;.;x;x;.;.;.;f;.;.;.;.;.;.;.;.;.;.;.;.;.;.;.;.;.;x;_;_;_;_;x;x;x;x;x;x;.;x;_;_;x;x;x;_;_;x;x;.;.;.;.;m;.;.;.;.;.;.;.;.;x;x;x;.;.;.;.;.;.;.;.;.;.;x;x;x;.;.;.;.;.;.;x;x;x;_;_;_;x;x;x;.;x;.;.;.;.;x;
x;.;x;.;x;x;x;.;.;.;.;.;.;.;.;.;.;.;.;.;.;.;.;.;.;.;.;x;_;_;_;_;_;_;_;x;.;.;.;x;x;x;_;_;_;_;_;_;x;.;.;.;.;.;.;.;.;.;.;.;.;.;.;.;.;.;.;.;.;.;.;.;.;.;.;.;x;x;x;.;.;.;.;.;.;.;x;x;_;x;x;.;.;.;.;.;.;.;.;x;
x;.;x;.;x;_;x;.;.;.;.;.;.;.;x;.;.;x;.;.;.;.;.;.;.;.;.;x;_;_;_;_;_;_;x;x;.;.;.;.;.;x;x;x;x;_;_;x;x;.;x;x;x;x;.;.;.;.;.;.;.;.;x;x;x;.;.;.;.;.;.;.;.;.;.;x;x;x;.;.;.;.;.;.;.;.;.;x;x;x;.;.;.;.;.;.;.;.;.;x;
x;x;x;x;x;x;x;x;.;.;.;.;.;.;.;x;x;x;.;.;.;.;.;.;.;.;.;x;_;_;_;_;_;_;x;.;.;.;.;.;.;.;.;.;x;x;x;x;.;.;.;.;x;x;.;.;.;.;.;.;.;.;.;x;x;.;.;.;.;.;.;.;.;.;.;x;_;x;x;.;.;.;.;.;.;.;.;.;x;x;.;.;.;.;.;.;.;.;.;x;
_;x;.;.;.;.;.;.;.;.;.;.;.;.;.;.;x;x;x;.;.;.;.;.;.;.;.;x;x;x;x;x;_;_;x;x;x;.;.;.;.;.;.;.;.;.;x;x;.;.;.;.;x;.;.;.;.;.;.;.;.;x;.;x;x;x;.;.;.;.;.;.;.;.;x;x;_;_;x;x;.;.;.;.;.;.;.;.;x;x;x;.;.;.;.;.;.;.;.;x;
x;x;x;.;.;.;.;.;.;.;x;.;.;.;.;.;x;x;x;.;.;.;.;.;.;x;.;x;.;.;.;x;x;_;_;x;x;.;.;.;.;.;.;.;.;.;.;x;.;.;.;.;.;.;.;.;.;.;.;.;x;x;x;x;x;x;x;.;.;.;.;.;.;.;x;x;x;_;_;x;x;.;.;.;.;.;.;.;.;x;x;.;.;.;.;.;.;.;.;x;
x;.;.;.;.;.;.;.;.;.;.;.;.;.;.;.;.;x;x;.;.;.;.;.;.;x;.;.;.;.;.;.;x;x;_;x;.;.;.;.;.;.;.;.;.;.;.;x;x;.;.;.;.;.;.;.;.;.;.;.;.;.;.;.;.;x;x;x;x;x;.;.;.;.;.;.;x;x;x;x;x;.;.;.;.;.;.;.;.;x;.;.;.;.;.;.;.;.;.;x;
x;x;.;x;.;.;m;.;.;.;.;.;.;.;.;.;.;x;x;.;.;.;.;.;x;x;.;.;.;.;.;.;.;x;x;x;.;.;.;.;.;.;.;.;.;.;.;x;x;.;.;.;.;.;.;.;.;.;.;.;.;.;.;x;x;x;_;_;_;x;x;.;.;.;.;.;.;.;.;.;.;.;.;.;.;.;.;.;.;x;.;.;.;.;.;x;.;.;.;x;
_;x;.;x;x;.;.;.;.;.;.;.;.;.;.;.;.;x;x;x;.;.;.;x;x;x;.;.;.;.;.;r;.;x;x;.;.;.;.;.;.;m;.;.;.;.;x;x;x;.;.;.;.;.;.;.;.;.;.;.;.;.;.;.;.;x;_;_;_;x;x;.;.;.;.;.;.;.;.;.;.;.;.;m;.;.;.;.;.;.;.;.;.;x;x;x;.;.;.;x;
_;x;x;x;x;.;.;.;.;.;.;.;.;.;.;.;.;x;x;x;.;.;.;x;_;x;.;.;.;.;.;.;.;.;x;.;.;.;.;.;.;.;.;.;.;x;x;x;x;.;.;.;.;.;.;.;.;.;.;.;.;.;.;x;x;x;_;_;_;x;.;.;.;.;.;.;.;.;.;.;.;.;.;.;.;.;.;.;.;.;.;x;.;x;x;x;.;.;.;x;
_;_;_;x;x;.;.;.;.;.;.;.;.;.;.;.;.;.;x;x;x;x;x;x;x;x;.;.;.;.;.;.;.;.;.;.;.;.;.;.;.;.;.;.;.;.;.;x;x;x;.;.;.;.;.;.;.;.;.;.;.;.;.;x;_;_;x;x;x;x;x;x;.;.;.;.;.;.;.;.;.;.;.;.;.;.;.;.;.;.;.;.;.;.;.;.;.;.;.;x;
_;_;_;x;.;.;.;.;.;.;.;.;.;.;x;x;.;.;.;x;_;_;x;x;x;.;.;.;.;.;.;.;.;.;.;.;.;.;.;.;.;.;.;.;.;.;.;.;.;x;x;x;x;x;x;x;x;x;.;.;x;x;x;x;_;_;x;.;.;x;_;x;x;x;x;x;x;x;x;.;.;.;.;.;.;.;.;.;.;.;.;.;.;.;.;.;.;.;.;x;
_;_;_;x;.;.;.;.;.;.;.;.;.;.;.;x;.;.;.;x;_;_;x;.;.;.;.;.;.;.;.;.;.;.;.;.;.;.;.;.;.;.;.;.;.;.;.;.;.;.;x;_;_;x;x;x;.;.;.;x;x;_;_;_;_;x;x;.;.;x;x;_;_;_;_;_;x;x;x;.;.;.;.;.;.;.;.;.;.;.;.;.;.;.;.;.;.;.;.;x;
_;_;_;x;.;.;.;.;.;x;.;.;.;.;.;.;x;x;.;x;_;_;x;.;.;.;.;.;.;.;.;.;.;.;.;.;.;.;.;.;.;.;.;.;.;.;.;.;.;.;x;x;x;x;.;.;.;.;x;x;_;_;_;_;_;x;.;.;.;.;x;_;_;_;_;_;x;.;.;.;.;.;.;.;.;.;.;.;.;.;.;.;.;.;.;.;.;.;x;x;
_;_;_;x;x;.;.;.;x;x;.;.;.;.;.;.;x;x;x;x;_;_;x;.;m;.;.;.;x;.;.;.;.;.;.;m;.;.;.;.;.;.;.;.;.;.;.;.;f;.;.;x;x;.;.;.;.;.;.;x;_;_;_;_;_;x;x;.;.;x;x;_;_;_;_;x;x;.;.;.;.;.;.;.;.;.;.;.;.;.;.;.;.;.;.;.;.;.;x;_;
_;_;_;x;x;.;.;.;.;.;.;.;.;.;.;.;.;x;_;_;_;x;x;.;.;.;.;.;x;x;.;.;.;.;.;.;.;.;.;.;.;.;.;.;.;.;.;.;.;.;.;x;.;.;.;.;.;.;.;x;x;x;_;_;_;_;x;.;.;x;x;x;x;x;_;x;.;.;.;.;.;.;.;.;.;.;.;.;.;.;.;.;.;.;.;.;x;x;x;_;
_;x;x;x;.;.;.;.;.;.;.;.;.;.;.;.;x;x;_;_;_;x;.;.;.;.;.;.;x;x;.;.;.;.;.;.;.;.;.;.;.;.;.;.;.;.;.;.;.;.;.;x;.;.;.;.;.;.;.;x;.;x;x;x;x;_;x;x;x;x;.;.;.;x;x;x;x;.;.;.;.;.;.;.;.;.;.;.;.;.;.;.;.;.;.;x;x;_;_;_;
x;x;.;.;.;.;.;.;.;.;.;.;.;.;.;.;x;_;_;_;_;x;x;.;.;.;.;.;x;.;.;.;x;x;x;x;x;x;x;x;.;.;.;.;.;.;.;.;.;.;x;x;.;.;.;.;.;.;.;.;.;x;x;.;x;_;_;x;x;x;.;.;.;.;x;.;.;.;.;.;.;.;x;x;x;.;.;.;.;.;.;.;.;.;.;x;x;_;_;_;
x;.;.;.;.;.;.;.;.;.;.;.;.;.;.;.;x;_;x;x;x;_;x;.;.;.;.;x;x;.;.;.;.;x;x;x;x;x;x;.;.;.;.;.;.;.;.;.;x;x;x;.;.;.;.;.;.;.;.;r;.;.;.;.;x;x;x;x;.;.;.;.;.;.;.;x;.;.;.;.;.;x;x;x;x;x;.;.;.;.;.;.;.;.;.;.;x;_;_;_;
x;.;.;.;.;.;.;.;.;.;.;.;.;.;.;.;x;_;x;.;x;_;x;x;x;.;x;x;x;x;.;.;.;.;.;.;.;x;x;.;.;.;.;.;.;.;x;x;x;x;x;.;.;.;.;.;.;.;.;.;.;.;.;.;.;.;x;x;x;.;.;.;.;.;.;.;.;.;.;.;.;x;_;x;.;.;.;.;.;x;.;.;.;.;.;.;x;_;_;_;
x;.;.;.;.;.;.;.;.;.;.;.;.;.;.;x;x;x;x;x;x;x;x;x;x;x;x;_;_;x;.;.;.;.;.;.;.;.;.;.;.;.;.;.;.;.;.;.;.;.;.;.;.;.;.;.;.;.;.;.;.;.;.;.;.;.;x;x;.;.;.;.;.;x;.;.;.;.;.;.;.;x;x;x;.;.;.;x;x;x;.;.;.;.;.;.;x;_;_;_;
x;.;.;.;.;.;x;.;.;.;.;.;.;.;.;x;x;.;.;.;.;.;.;.;.;.;x;x;x;x;.;.;.;.;.;.;.;.;.;.;.;.;.;.;.;.;.;.;.;.;.;.;.;.;.;.;.;.;.;.;.;.;.;.;.;.;x;x;.;.;.;.;.;.;.;.;.;.;.;.;.;x;x;.;.;.;.;.;x;x;.;f;.;.;.;.;x;_;_;_;
x;.;.;.;.;x;x;.;.;.;.;.;.;.;x;x;x;x;x;x;x;.;.;.;.;.;.;x;x;.;.;.;.;.;.;.;.;.;.;.;.;.;.;.;.;.;.;.;.;.;.;.;.;.;.;.;.;.;.;.;.;.;.;.;.;.;x;.;.;.;.;.;.;.;.;.;.;.;.;.;.;.;.;.;.;.;.;x;x;x;.;.;.;.;.;.;x;_;_;_;
x;.;.;.;.;x;x;.;.;.;.;.;.;x;x;_;_;x;.;.;.;.;.;.;.;.;.;.;.;.;.;.;.;.;.;.;.;.;.;.;.;.;.;.;.;.;.;.;.;.;.;x;.;.;.;x;.;.;.;.;.;.;.;.;.;x;x;.;.;.;.;.;.;r;.;.;.;.;.;.;.;.;.;.;.;.;.;x;x;x;.;.;.;.;.;.;x;_;_;_;
x;.;.;m;.;.;.;.;.;.;.;.;.;x;x;x;x;x;x;x;x;.;r;.;.;.;.;.;.;.;.;.;.;.;.;.;.;.;.;.;.;.;.;.;.;.;.;.;.;.;.;.;.;.;.;x;x;.;.;.;.;.;.;.;.;x;x;.;.;r;.;.;.;.;.;.;.;.;.;.;.;.;f;.;.;.;.;x;x;.;.;.;.;.;.;.;x;_;_;_;
x;.;.;.;.;.;.;.;.;.;.;.;.;x;x;.;x;x;_;_;x;.;.;.;.;.;.;.;.;.;.;.;.;.;.;.;.;.;.;.;.;.;.;.;.;.;.;.;.;.;.;.;.;.;.;.;x;.;.;.;.;.;.;x;x;x;x;.;.;.;.;.;.;x;.;.;.;.;.;.;.;.;.;.;.;.;x;x;x;.;.;.;.;.;.;.;x;_;_;_;
x;.;.;.;.;.;.;.;.;.;.;.;.;.;.;.;.;x;x;x;x;.;.;.;.;.;.;.;.;.;.;.;.;.;.;.;.;x;.;.;.;.;.;.;.;.;.;.;.;.;.;.;.;.;.;x;x;.;.;.;.;.;.;.;x;_;x;.;.;.;.;.;x;x;x;.;.;.;.;.;.;.;.;.;.;.;x;x;x;.;.;.;.;.;.;.;x;x;x;_;
x;.;.;.;.;.;.;.;.;.;.;.;.;.;.;.;.;.;x;x;.;.;.;x;x;x;.;.;.;.;.;.;.;.;.;.;.;.;.;.;.;.;.;.;.;.;.;.;.;.;.;.;.;.;.;.;.;.;.;.;.;.;.;x;x;_;x;x;.;.;.;x;x;_;x;x;.;.;x;x;x;x;.;.;.;x;x;x;.;.;.;.;.;.;.;.;.;.;x;x;
x;.;.;.;.;.;.;.;.;.;.;.;.;.;.;.;.;.;.;x;.;.;.;x;x;x;x;x;.;.;.;.;.;.;.;.;.;.;.;.;.;.;.;.;.;.;.;.;.;.;x;x;x;.;.;.;x;.;.;.;.;.;.;.;x;x;x;x;x;x;x;x;_;_;_;x;x;.;.;.;.;x;x;x;x;x;x;.;.;.;.;.;.;.;.;.;.;.;.;x;
x;.;.;.;.;.;.;.;.;.;.;.;.;.;.;.;.;.;.;.;.;.;.;.;x;.;x;x;x;.;.;.;.;.;.;.;.;.;.;.;.;.;.;.;.;.;.;.;.;.;x;.;.;.;.;.;.;.;.;.;.;.;.;.;.;x;.;x;x;x;x;x;x;x;x;_;x;x;x;.;.;.;x;x;_;x;.;.;.;.;.;.;.;.;.;.;.;.;.;x;
x;.;.;.;.;.;.;.;.;.;.;.;.;.;.;.;.;.;.;.;.;.;.;.;.;.;x;x;x;x;.;.;.;.;.;.;.;.;x;.;.;.;.;.;.;.;.;.;x;.;.;.;.;.;.;.;.;.;.;.;.;.;.;.;x;x;x;.;.;x;x;.;.;.;x;x;x;x;.;.;.;.;.;x;x;x;.;.;.;.;r;.;.;.;.;.;.;.;.;x;
x;.;.;.;x;x;.;.;.;.;.;.;.;x;x;x;.;.;.;.;.;.;.;.;.;.;.;.;x;x;.;.;.;.;.;.;x;x;x;x;x;.;x;.;.;.;.;.;x;.;.;.;.;.;.;.;.;.;.;.;.;.;.;.;x;_;x;.;x;.;.;.;.;.;.;.;x;x;.;.;.;.;.;x;x;.;.;.;.;.;.;.;.;.;.;.;.;.;.;x;
x;.;.;.;x;x;.;.;.;.;.;.;.;x;x;x;.;f;.;.;.;.;.;.;.;.;.;.;x;x;.;.;.;r;.;.;x;_;x;x;x;.;.;.;.;.;.;.;.;.;.;.;.;.;.;.;.;.;.;.;.;.;.;.;x;x;x;x;x;.;.;.;.;.;.;.;.;.;.;.;.;.;.;x;x;.;.;.;.;.;.;.;.;.;.;.;.;.;.;x;
x;.;.;.;x;.;.;.;.;.;.;.;.;.;x;x;.;.;.;.;.;.;.;.;.;.;.;.;.;.;.;.;.;.;.;x;x;_;x;.;x;.;x;.;.;.;.;.;.;.;.;.;.;.;.;.;.;.;.;.;.;.;.;.;.;x;_;_;x;.;x;.;.;.;.;.;.;.;.;.;.;.;x;x;.;.;.;.;.;.;.;.;.;f;.;.;.;.;.;x;
x;.;x;x;x;.;.;.;.;.;.;.;.;.;.;x;.;m;.;.;.;.;.;x;x;.;.;.;.;.;.;.;.;.;.;x;_;_;x;x;x;.;x;x;x;.;.;.;.;.;.;x;.;.;.;.;.;0;.;.;.;.;.;.;.;x;_;_;x;x;x;.;.;.;.;.;.;.;.;.;.;x;x;x;.;.;.;.;.;.;.;.;.;.;.;.;.;.;.;x;
x;x;x;_;x;.;.;.;.;.;.;.;.;.;.;x;.;.;.;.;.;m;.;x;x;.;.;.;r;.;.;.;.;.;x;x;x;x;x;_;x;x;x;_;x;.;.;.;.;.;.;x;x;x;x;.;.;.;.;.;.;.;.;.;.;x;_;_;_;_;x;x;.;.;.;.;.;.;.;x;x;x;x;.;.;.;.;.;.;.;.;x;x;x;x;x;.;.;.;x;
_;_;_;_;x;.;.;.;.;.;.;.;.;.;.;x;.;x;.;.;.;.;.;x;x;x;.;.;.;.;.;.;.;.;.;.;.;.;x;x;_;_;_;_;x;x;.;.;.;.;.;x;x;x;x;x;.;.;.;.;.;.;.;.;.;x;_;_;_;_;_;x;.;.;.;.;.;.;.;.;x;x;x;.;.;.;.;.;.;.;.;x;_;_;_;x;.;.;.;x;
_;_;_;_;x;.;.;.;.;.;.;.;.;.;.;x;x;x;.;x;.;x;x;x;_;x;.;.;.;.;.;.;.;.;.;.;.;.;.;x;_;_;x;x;x;x;x;x;.;x;.;x;.;x;_;x;.;.;.;.;.;.;.;.;.;x;x;_;_;_;_;x;.;.;.;.;.;.;.;x;x;x;.;.;.;.;.;.;.;.;x;x;x;x;x;x;.;.;.;x;
_;_;_;_;x;.;.;.;.;.;.;.;.;.;x;x;x;x;x;x;x;x;_;_;_;x;x;.;.;.;.;.;.;.;.;.;.;.;.;x;_;_;x;.;.;.;x;x;x;x;.;x;x;x;_;x;x;.;.;.;.;.;.;.;.;.;x;x;x;_;_;x;x;.;.;.;.;.;.;.;x;x;x;.;.;.;.;.;.;x;x;x;x;.;x;x;x;.;.;x;
_;_;_;_;x;.;.;.;.;.;.;.;.;.;.;.;x;.;x;x;x;x;x;x;x;_;x;.;.;.;.;.;.;.;.;.;.;.;.;x;_;x;x;.;.;.;.;x;x;x;x;x;_;_;_;x;.;.;.;.;.;.;.;.;.;.;.;.;x;_;_;_;x;.;.;.;.;.;.;.;x;_;x;.;.;.;.;x;x;x;x;.;.;.;.;.;.;.;.;x;
_;_;_;_;x;.;.;.;.;.;.;.;.;.;.;.;.;.;x;.;x;.;x;.;x;x;x;x;x;.;x;x;x;.;.;.;.;.;x;x;_;x;.;.;.;.;.;.;x;_;x;x;x;x;x;x;.;.;.;.;.;.;.;.;.;.;.;.;x;x;x;x;x;.;.;.;.;.;.;.;x;_;x;x;x;x;x;x;x;x;.;.;.;.;.;.;x;x;x;x;
_;_;_;_;x;.;.;.;.;.;.;.;.;.;.;.;.;.;.;.;x;.;.;.;.;x;x;_;x;x;x;_;x;x;x;.;.;x;x;_;x;x;.;.;.;.;.;.;x;x;x;.;.;.;.;.;.;.;.;.;.;.;.;.;.;.;r;.;.;.;x;x;.;.;.;.;.;.;.;.;x;_;_;_;_;_;_;_;x;.;.;.;.;.;.;.;.;.;x;_;
_;_;_;_;x;.;.;.;.;.;.;.;.;.;.;.;.;.;.;.;.;.;.;.;.;.;x;x;_;_;_;_;_;x;x;x;.;x;x;x;x;.;.;.;.;.;.;.;.;.;.;.;.;.;.;.;.;.;.;.;.;.;.;.;.;.;.;.;.;.;x;x;x;.;.;.;.;.;.;x;x;_;_;_;_;_;_;_;x;x;.;.;.;.;.;.;x;x;x;x;
_;_;_;_;x;x;.;.;.;.;.;.;.;.;.;.;.;.;.;.;.;.;.;.;.;.;.;x;x;_;_;_;x;x;.;.;.;.;x;x;.;.;.;.;.;.;.;.;.;.;.;.;.;.;.;.;.;.;.;.;.;.;.;.;.;.;.;.;.;.;x;x;x;.;.;.;.;.;.;x;x;_;_;_;_;x;x;x;_;x;x;.;.;.;.;x;.;x;.;x;
_;_;_;x;x;x;x;.;.;.;.;.;.;.;.;.;.;.;.;m;.;.;.;.;.;.;.;.;x;x;_;x;x;.;.;.;.;.;.;x;x;.;.;.;.;.;.;.;.;.;.;.;.;.;.;.;.;.;.;.;.;.;.;.;.;.;m;.;.;.;.;x;x;.;.;.;.;.;.;.;x;_;_;x;x;x;.;x;x;_;x;x;.;.;x;x;.;x;.;x;
_;x;x;x;.;.;.;.;.;.;.;.;.;.;.;.;x;x;.;.;.;.;.;.;.;.;.;.;.;x;x;x;.;.;.;.;.;.;.;x;x;.;.;.;.;.;.;.;.;.;.;.;.;.;p;.;.;.;x;.;.;.;.;.;.;.;.;.;.;.;x;x;x;.;.;.;.;.;.;.;x;x;x;x;.;.;.;.;x;x;x;x;.;x;x;x;.;x;.;x;
_;x;.;.;.;.;.;.;.;x;.;.;.;.;.;.;x;x;.;.;.;x;x;.;.;.;.;.;.;.;.;.;.;.;.;.;.;.;.;x;x;x;x;.;.;.;f;.;.;.;.;.;.;.;.;.;.;x;x;.;.;.;.;.;.;.;.;.;.;.;x;x;.;.;.;.;.;.;.;.;.;x;x;.;.;.;.;.;.;x;.;.;.;.;.;.;.;.;.;x;
x;x;.;.;.;.;.;.;.;.;.;.;.;.;.;.;x;x;x;x;x;x;x;x;.;.;.;.;.;.;.;.;.;.;.;.;.;.;.;x;x;_;x;.;.;.;.;.;.;.;.;.;.;.;.;.;x;x;.;.;.;.;.;.;.;.;.;.;.;.;.;.;.;.;.;r;.;.;.;.;.;x;x;.;r;.;.;.;.;.;.;f;.;.;.;.;.;.;.;x;
x;.;.;.;.;.;.;.;.;.;.;.;.;.;.;.;x;_;_;_;_;_;_;x;x;.;.;.;.;.;.;.;.;.;m;.;.;.;.;.;x;x;x;.;.;.;.;.;.;.;.;.;.;.;.;.;x;x;.;.;.;.;.;.;.;.;.;.;.;.;.;.;.;.;.;.;.;.;.;.;.;x;.;.;.;.;.;.;.;.;.;.;.;.;.;.;.;.;.;x;
x;.;.;.;.;.;.;.;.;.;.;.;.;.;.;.;x;_;_;_;_;_;_;_;x;x;x;.;.;.;.;.;.;.;.;.;.;.;.;.;x;x;.;.;.;.;.;.;.;.;.;.;.;.;.;.;x;.;.;.;.;.;.;.;.;.;.;.;.;.;.;.;.;.;.;.;.;.;.;.;.;x;x;.;.;.;.;.;.;.;.;.;.;.;.;.;.;.;.;x;
x;.;.;.;.;.;.;x;x;x;.;.;.;.;.;.;x;_;_;_;_;_;_;_;_;_;x;x;.;.;.;.;.;.;.;.;.;.;.;.;x;x;.;.;.;.;.;.;.;.;.;.;.;.;.;.;x;.;.;.;.;.;.;.;.;.;.;.;.;.;.;.;.;.;.;x;.;.;r;.;.;x;x;.;.;.;.;.;.;.;.;.;.;.;.;.;.;.;x;x;
x;.;.;.;.;.;.;x;_;x;x;.;.;.;.;x;x;_;_;_;_;_;_;_;_;_;_;x;.;.;.;.;.;.;x;x;.;.;.;.;.;.;.;.;.;.;.;.;.;.;.;.;.;.;.;x;x;.;.;.;.;.;.;.;.;.;.;.;.;.;.;.;.;.;.;x;.;.;.;.;.;.;x;x;.;.;.;.;.;.;.;.;.;.;.;.;.;x;x;_;
x;.;.;.;.;.;x;x;_;_;x;x;x;.;x;x;_;_;_;_;_;_;_;_;_;_;_;x;.;.;.;.;.;.;.;x;x;.;.;.;.;.;.;.;.;.;.;.;.;.;.;.;.;.;.;x;x;.;.;.;.;.;.;.;.;.;.;.;.;.;.;.;.;.;.;.;.;.;.;.;.;.;x;x;x;.;.;.;.;.;.;.;.;.;.;.;x;x;_;_;
x;.;.;.;.;.;x;_;_;_;_;_;x;x;x;_;_;_;_;_;_;_;_;_;_;_;_;x;.;.;.;.;.;f;.;x;x;x;x;.;.;.;.;.;.;.;.;.;.;.;.;.;.;.;.;x;x;x;.;.;.;.;.;.;.;.;.;.;.;.;.;.;.;.;.;.;x;.;.;.;.;.;.;.;x;x;.;.;.;.;.;.;.;.;.;.;.;x;_;_;
x;.;.;.;.;.;x;x;x;_;_;_;x;x;x;x;x;x;x;x;x;x;x;_;_;_;x;x;.;.;.;.;.;.;.;.;x;_;x;x;.;.;.;.;.;.;.;.;.;.;.;.;.;.;.;x;_;x;x;.;.;.;.;.;.;.;.;.;.;.;.;.;.;.;.;.;x;.;x;x;x;.;.;.;x;x;x;x;.;x;x;.;.;.;.;.;.;x;x;x;
x;.;.;.;.;.;.;.;x;x;x;x;x;.;.;.;.;x;x;.;.;.;x;x;_;_;x;.;.;.;.;.;.;.;x;x;x;_;_;x;.;.;.;.;.;.;.;.;.;.;.;.;.;.;x;x;x;x;x;x;x;.;.;.;.;.;.;.;.;.;.;.;.;.;.;x;x;x;x;x;x;.;.;.;.;.;x;x;x;x;x;x;x;.;.;.;.;.;.;x;
x;.;.;.;.;.;x;.;x;.;.;.;.;.;.;.;.;x;x;.;.;.;.;x;x;x;x;.;.;.;.;x;x;x;x;_;_;x;x;x;.;.;.;.;.;.;.;.;.;.;.;.;.;x;x;x;.;.;.;x;x;x;.;.;.;.;.;.;.;.;.;.;.;.;.;.;x;_;x;.;.;.;.;.;.;.;.;.;x;x;x;x;x;.;x;.;x;.;x;x;
x;.;.;.;.;.;x;.;.;.;.;.;.;.;.;.;.;.;.;.;.;.;.;.;.;.;.;.;.;.;.;.;x;_;_;_;_;x;.;.;.;.;.;.;x;x;x;x;x;x;.;x;x;x;x;x;.;.;.;.;x;x;.;.;.;.;.;.;.;.;.;.;.;.;.;.;x;_;x;x;.;.;.;.;.;.;.;.;.;x;.;x;x;x;x;x;x;.;x;_;
x;.;.;.;.;.;x;x;.;.;.;.;.;.;.;.;.;.;x;.;.;.;.;.;.;.;.;.;.;.;.;.;x;_;_;x;x;x;.;.;.;.;.;.;x;x;x;x;_;x;.;.;.;x;x;.;.;.;.;.;.;.;.;.;.;.;.;.;.;.;.;.;.;.;.;.;x;_;_;x;.;.;.;.;.;.;.;.;.;.;.;x;x;x;_;x;x;x;x;x;
x;.;.;.;.;.;x;x;x;.;.;.;.;.;.;.;.;.;x;x;.;.;.;.;.;.;.;.;.;.;.;.;x;x;_;x;.;.;.;.;.;.;.;.;.;.;.;x;x;x;x;x;x;x;x;x;.;.;.;.;.;.;.;.;.;.;.;.;.;.;.;.;.;.;.;x;x;_;x;x;.;.;x;x;x;x;.;x;.;.;.;.;.;x;x;x;.;.;.;x;
x;.;.;.;.;.;x;x;x;x;.;.;.;.;.;.;.;x;x;x;x;x;.;.;.;.;.;.;.;r;.;.;.;x;x;x;x;x;.;.;.;.;.;.;.;.;.;.;x;_;x;.;.;x;x;x;.;.;.;.;.;.;.;.;.;.;x;x;x;x;x;x;.;.;x;x;_;x;x;.;.;.;.;.;.;x;.;x;.;.;.;.;.;x;x;.;.;.;.;x;
x;.;.;.;.;.;.;x;_;x;x;.;.;.;.;.;.;x;_;_;x;.;.;.;.;.;.;.;.;.;.;.;.;x;.;.;.;.;.;.;.;.;.;.;.;.;.;.;x;x;x;x;x;x;.;x;.;.;.;.;.;.;.;.;x;x;x;_;x;x;.;.;.;x;x;x;_;x;.;.;.;.;.;.;.;.;.;x;.;.;.;.;x;x;x;.;.;.;.;x;
x;.;.;.;.;.;x;x;x;x;x;.;.;.;.;.;.;x;x;x;x;x;.;.;.;.;.;.;.;.;.;.;.;x;x;.;.;x;x;x;x;x;x;.;.;.;.;.;.;x;_;x;.;.;.;.;.;.;.;.;.;.;x;x;x;_;x;x;x;.;.;.;.;.;.;x;_;x;x;.;.;m;.;.;.;.;.;.;.;.;.;.;x;x;.;.;.;.;.;x;
x;.;.;.;.;.;.;.;x;.;.;.;.;.;.;.;.;.;.;x;x;.;.;.;.;x;.;.;.;.;.;.;.;.;.;.;.;.;x;_;x;x;x;.;.;.;.;.;.;x;x;x;.;.;.;.;.;.;x;x;x;x;x;_;_;_;x;.;.;.;.;.;.;.;.;x;_;_;x;.;.;.;.;.;.;.;.;.;.;.;.;.;x;x;.;.;.;.;.;x;
x;.;.;.;.;.;.;.;.;.;.;.;.;.;.;.;.;.;.;x;x;x;.;.;.;.;.;.;.;.;.;.;.;.;.;.;.;.;x;x;x;.;.;.;.;.;.;.;.;.;.;.;.;.;.;.;.;.;.;x;.;.;x;x;x;x;x;.;.;.;.;.;.;.;x;x;x;_;x;x;.;.;.;.;.;.;.;.;.;.;.;.;x;x;x;.;.;.;.;x;
x;.;.;.;.;.;.;.;.;.;.;.;.;.;x;.;.;.;.;.;x;x;.;.;.;.;.;.;.;.;.;.;.;.;.;.;.;.;x;.;x;.;.;.;.;.;.;x;x;.;.;.;.;.;.;.;.;.;.;.;.;x;x;.;.;.;.;.;.;.;.;.;.;.;.;.;x;x;_;x;x;.;.;.;.;.;x;.;.;.;.;.;x;x;x;x;.;.;.;x;
x;.;.;.;.;.;.;.;.;.;.;.;.;.;x;x;.;.;.;.;x;x;.;.;.;.;.;.;.;.;.;.;.;.;.;.;.;.;.;.;.;.;.;.;.;.;.;.;.;.;.;.;.;.;.;.;.;.;.;.;.;.;.;x;.;.;f;.;.;.;.;.;x;x;.;x;.;x;x;x;.;.;.;.;.;x;x;.;.;.;.;.;.;x;x;x;x;x;x;x;
x;.;.;.;.;.;.;.;.;.;.;.;.;.;x;x;.;.;.;x;x;x;x;.;.;.;.;.;.;.;.;.;.;.;.;m;.;.;.;.;.;.;.;.;.;.;.;.;.;.;.;.;.;.;.;.;.;.;.;.;.;x;x;x;.;.;.;.;.;.;.;.;x;x;.;.;.;.;.;x;.;.;.;.;.;.;x;.;.;.;.;.;.;.;x;_;_;_;_;_;
x;.;.;.;.;.;.;.;.;.;.;.;.;.;x;x;.;.;.;.;x;_;x;x;.;.;.;.;.;.;.;.;.;.;.;.;.;.;.;.;.;.;.;.;.;.;.;.;.;.;.;.;.;.;.;.;.;.;.;.;.;.;x;x;x;.;.;.;.;.;.;x;x;x;x;.;.;.;.;.;x;x;x;x;x;x;x;.;.;.;r;.;.;.;x;x;x;x;x;x;
x;.;.;.;.;x;x;.;.;.;.;.;.;.;.;.;.;.;.;x;x;_;_;x;x;.;.;.;.;.;.;.;.;.;.;f;.;.;.;.;.;.;.;.;.;.;.;.;.;.;.;.;.;.;x;.;.;.;.;.;.;.;x;x;x;x;.;.;.;.;.;x;_;_;x;.;.;.;m;.;x;x;.;.;.;.;.;x;.;.;.;.;r;.;x;x;.;.;.;x;
x;.;.;.;.;x;x;x;x;.;.;.;.;.;.;.;.;.;.;.;x;_;_;_;x;.;.;.;.;.;x;.;.;.;.;.;.;.;.;.;.;.;.;.;.;x;x;x;.;m;.;.;.;x;x;.;.;.;.;.;.;.;.;.;x;x;x;.;.;.;x;x;_;_;x;x;.;.;.;.;x;x;x;x;x;x;x;x;.;.;.;.;.;.;x;x;x;x;x;x;
x;.;.;.;x;x;_;_;x;.;.;.;.;.;.;.;.;.;.;x;x;_;_;_;x;x;x;.;.;.;x;x;.;.;.;.;.;.;.;.;.;.;.;.;.;x;_;x;.;.;.;.;.;x;x;x;.;.;.;.;.;.;.;x;x;_;x;x;.;.;x;_;_;_;_;x;x;.;.;.;x;_;x;.;.;x;_;x;x;.;.;.;.;.;x;_;x;.;x;_;
x;x;x;x;x;_;_;_;x;x;x;x;x;x;x;x;x;x;x;x;_;_;_;_;_;_;x;x;x;x;x;x;x;x;x;x;x;x;x;x;x;x;x;x;x;x;_;x;x;x;x;x;x;x;_;x;x;x;x;x;x;x;x;x;_;_;_;x;x;x;x;_;_;_;_;_;x;x;x;x;x;_;x;x;x;x;_;_;x;x;x;x;x;x;x;_;x;x;x;_;
