_;x;x;x;x;x;x;x;_;_;_;_;_;_;x;x;x;_;_;_;_;x;x;x;x;x;x;x;_;_;_;_;_;_;_;_;_;_;_;_;x;x;x;x;x;x;x;x;x;x;x;x;x;x;_;_;_;_;_;_;_;_;_;_;_;_;_;_;x;x;x;x;x;x;x;x;x;x;_;_;_;_;x;x;x;x;x;x;x;x;x;x;x;x;x;x;x;x;_;_;
x;x;.;.;.;.;.;x;_;_;_;_;_;_;x;.;x;x;x;x;x;x;.;.;.;.;.;x;x;_;_;_;_;_;_;_;_;_;_;x;x;.;.;.;.;.;.;.;.;.;.;.;.;x;x;_;_;_;_;_;_;x;x;x;x;x;_;x;x;.;.;.;.;.;.;x;.;x;_;_;_;x;x;.;.;.;.;.;.;.;.;.;.;.;.;.;.;x;x;x;
x;.;.;.;.;.;.;x;x;_;_;_;_;x;x;.;.;.;.;.;x;.;.;.;.;.;.;.;x;_;_;_;_;x;x;x;_;_;_;x;.;.;.;.;.;.;.;.;.;.;.;.;.;.;x;x;_;_;_;_;_;x;.;x;.;x;x;x;.;.;.;.;.;.;.;.;.;x;x;_;_;x;.;.;.;.;.;.;.;.;.;.;.;.;.;.;.;.;.;x;
x;.;.;.;.;.;.;.;x;_;_;_;_;x;.;.;.;.;.;.;.;.;.;.;.;.;.;x;x;x;x;x;x;x;.;x;x;x;_;x;x;.;.;.;.;.;.;.;.;.;.;.;.;.;.;x;_;_;_;x;x;x;.;.;.;x;x;.;.;.;.;.;.;m;.;.;.;.;x;x;x;x;.;.;.;.;.;.;.;.;.;.;.;.;.;.;.;.;.;x;
x;.;.;.;.;.;.;.;x;x;x;x;x;x;.;.;.;.;.;.;.;.;.;.;.;.;.;.;.;.;.;.;.;.;.;.;.;x;x;x;x;.;.;.;.;.;.;.;.;.;.;.;.;.;.;x;x;x;x;x;.;.;.;.;.;x;x;x;.;.;.;.;.;.;.;.;.;.;x;x;.;.;.;.;.;.;.;.;.;.;.;.;.;.;.;.;.;.;.;x;
x;.;.;.;.;.;.;.;.;.;.;.;x;x;x;.;.;.;.;.;.;.;.;.;.;.;.;.;.;.;.;.;.;.;.;.;.;.;x;x;.;.;.;.;.;.;x;x;x;.;.;.;.;.;.;.;x;x;.;.;.;.;.;.;.;x;.;.;.;.;x;.;.;.;.;.;.;.;x;.;x;x;x;.;.;.;.;.;.;.;.;.;.;.;.;.;.;.;.;x;
x;.;.;.;.;.;.;.;.;.;x;x;x;_;x;.;.;.;.;.;.;.;.;.;.;.;.;.;.;.;.;.;.;.;.;.;.;.;.;.;.;.;.;.;.;.;x;_;x;x;.;.;.;.;.;.;x;.;.;.;.;.;.;.;.;x;.;x;x;x;x;.;.;.;.;.;.;.;x;.;x;.;.;.;.;.;.;.;.;m;.;.;.;.;.;.;.;.;.;x;
x;.;.;.;f;.;.;.;.;.;.;.;x;x;x;.;.;.;.;.;.;.;.;.;.;.;.;.;.;.;.;.;.;.;.;.;.;.;.;.;.;.;.;.;.;.;x;x;x;x;.;.;.;.;.;x;x;.;.;.;.;.;.;.;.;.;.;.;.;x;x;.;.;.;.;.;.;.;x;x;x;x;x;x;.;.;.;.;.;.;.;.;.;.;.;.;.;.;.;x;
x;.;.;.;.;.;.;.;.;.;x;x;x;.;.;.;.;.;x;.;.;.;.;.;.;.;r;.;.;.;.;f;.;.;.;.;.;.;.;.;.;.;.;.;.;.;.;.;.;.;.;.;.;.;x;x;.;.;.;.;.;.;.;.;.;.;.;x;x;x;x;.;.;.;.;.;.;.;x;_;_;x;x;x;.;.;.;.;.;.;.;.;.;.;x;.;.;.;.;x;
x;.;.;.;.;.;.;.;.;.;.;x;x;.;.;.;.;.;x;x;.;.;.;.;.;.;.;.;.;.;.;.;.;.;.;.;.;.;.;.;.;.;.;.;.;.;.;.;.;.;.;.;x;x;x;x;x;.;.;.;.;.;.;x;.;.;.;.;x;_;x;x;.;.;.;.;.;x;x;x;x;x;.;.;.;.;.;.;.;.;x;x;x;x;x;.;.;.;.;x;
x;.;.;.;.;.;.;.;.;.;.;.;.;.;.;.;.;.;.;x;.;.;.;.;.;.;.;.;.;.;.;.;.;.;.;.;.;x;.;.;.;.;.;.;.;.;.;.;.;.;.;.;.;.;x;x;x;.;.;.;.;.;.;.;x;.;x;x;x;_;_;x;.;.;.;.;.;x;.;x;.;x;.;.;.;.;.;.;.;x;x;_;_;_;x;x;.;.;.;x;
x;.;.;.;.;.;.;.;.;.;.;x;.;.;.;.;.;.;.;.;.;.;.;.;.;.;.;.;.;.;.;.;.;.;.;.;x;x;.;.;.;.;.;.;.;.;.;.;.;.;.;.;.;.;.;x;x;x;.;.;.;.;.;.;.;.;x;_;_;_;_;x;x;.;.;.;.;x;.;.;.;.;.;.;.;.;.;.;.;x;_;_;_;_;_;x;.;.;.;x;
x;.;.;.;.;.;.;.;.;.;.;.;.;.;.;.;.;.;.;.;.;.;.;.;.;.;.;.;.;.;.;.;.;.;.;.;x;x;x;x;.;.;.;.;.;.;.;.;.;.;.;.;.;.;.;.;x;.;.;.;.;.;.;.;.;.;x;_;_;_;x;x;x;x;.;x;.;x;.;.;.;.;.;.;.;.;.;.;x;x;x;_;_;_;_;x;.;.;.;x;
x;.;.;.;.;x;.;.;.;.;.;.;.;.;.;.;.;.;.;.;.;.;.;.;.;.;.;.;.;.;.;.;.;.;.;.;x;_;_;x;.;.;.;.;.;.;.;.;.;.;.;.;.;.;.;x;.;.;.;.;x;x;.;.;.;.;x;_;x;x;x;.;x;x;x;x;x;x;.;.;.;.;.;.;.;.;.;.;x;.;x;_;_;_;_;x;x;x;.;x;
x;x;x;x;x;x;x;x;.;.;.;.;.;.;.;.;.;.;.;.;.;.;.;.;.;.;.;.;.;.;.;.;.;.;.;.;x;x;x;x;x;.;.;.;.;.;.;.;.;.;.;.;.;x;.;.;.;.;.;.;.;x;x;.;.;.;x;x;x;.;.;.;.;.;.;.;.;.;.;.;.;.;.;.;.;.;x;.;x;x;x;_;x;x;x;x;x;x;x;x;
x;.;.;.;.;.;.;.;.;.;.;.;.;.;.;.;.;.;.;.;.;.;.;.;.;.;.;.;.;.;.;.;.;.;.;.;.;.;x;.;x;.;.;.;.;.;.;.;.;.;.;.;x;x;.;.;.;.;.;.;.;x;x;x;x;x;x;x;.;.;.;.;.;.;.;.;.;.;x;.;.;.;.;.;x;.;x;x;x;_;_;x;x;.;.;.;x;_;_;_;
x;x;x;.;.;.;.;.;.;.;.;.;.;.;.;.;.;.;.;.;.;x;x;x;.;.;.;.;.;.;.;.;.;.;.;.;x;x;x;.;x;.;x;.;.;.;.;.;.;.;.;.;x;x;x;.;.;.;.;.;.;x;_;_;x;x;.;x;.;.;.;.;.;.;.;.;.;.;.;.;x;.;x;.;x;x;x;_;_;_;x;x;.;.;.;.;x;x;_;_;
_;x;.;.;.;.;.;.;.;.;f;.;.;.;.;.;.;.;.;x;x;x;_;x;x;x;x;x;.;.;.;.;.;.;.;.;.;.;.;.;x;x;x;x;x;x;.;.;.;.;.;.;.;x;x;.;.;.;.;.;.;x;_;x;x;.;.;.;.;.;.;.;.;.;.;.;.;.;x;x;x;x;x;x;x;x;x;_;_;_;x;.;.;.;.;.;.;x;x;_;
x;x;.;.;.;.;.;.;.;.;.;.;.;.;.;.;.;.;.;x;_;_;_;_;_;_;_;x;.;.;.;.;.;.;.;.;.;.;.;x;x;x;x;x;x;x;x;x;.;.;.;.;.;x;x;x;.;.;.;.;.;x;_;x;.;.;.;.;x;x;.;.;.;.;.;.;.;.;.;x;_;_;x;x;x;.;x;x;_;_;x;.;.;.;.;.;.;.;x;x;
x;.;.;.;.;.;.;.;.;.;.;.;.;.;.;.;.;.;.;x;_;_;x;x;x;x;x;x;x;.;.;.;.;.;.;.;r;.;.;.;x;x;.;.;x;x;_;x;x;.;.;.;.;x;_;x;.;.;.;.;.;x;_;x;x;.;.;x;x;x;x;.;.;.;.;.;.;.;x;x;x;x;x;.;.;.;.;x;x;x;x;.;.;.;.;.;.;.;.;x;
x;.;.;.;.;.;.;.;r;.;.;.;.;.;.;.;f;.;.;x;_;_;x;.;.;.;x;x;x;x;.;.;.;.;.;.;.;.;.;.;.;.;.;.;.;x;x;_;x;x;.;x;x;x;_;x;x;.;.;.;.;x;_;_;x;x;x;x;_;x;x;.;.;.;.;x;.;.;.;.;.;.;.;.;.;.;.;.;.;.;.;.;.;.;.;.;.;.;.;x;
x;.;.;.;.;.;.;.;.;.;.;x;x;x;.;.;.;.;.;x;x;x;x;.;.;.;.;.;x;.;.;.;.;.;.;.;r;.;.;.;.;.;.;.;.;.;x;_;_;x;x;x;_;_;_;_;x;x;x;x;x;x;_;_;_;_;x;x;x;x;.;.;.;.;.;x;x;x;x;.;.;.;.;.;.;.;.;.;.;.;.;.;.;.;.;.;.;.;.;x;
x;.;.;.;f;.;.;.;.;.;x;x;x;.;.;.;.;.;.;.;.;.;.;.;.;.;.;.;.;.;.;.;.;m;.;.;.;.;.;.;.;.;.;.;.;x;x;_;_;_;x;x;x;x;x;_;_;x;.;.;x;_;_;_;x;x;x;.;.;.;.;.;.;.;.;x;x;x;.;.;.;.;.;.;.;.;.;.;.;.;.;.;.;.;.;.;.;.;.;x;
x;.;.;.;.;.;.;.;.;.;x;_;x;.;x;x;.;.;.;.;.;.;.;.;.;.;.;.;.;.;.;.;.;.;.;.;.;.;.;.;.;.;.;.;.;x;x;x;x;x;x;.;.;.;x;x;_;x;x;x;x;_;x;x;x;.;.;.;.;.;.;.;.;.;.;.;x;.;.;.;.;.;.;.;.;.;x;.;.;.;.;.;.;.;.;.;.;.;.;x;
x;.;.;.;.;.;.;.;.;.;x;x;x;x;x;x;.;.;.;.;.;.;.;.;.;.;.;.;.;.;.;.;.;.;.;.;.;.;.;.;.;.;.;.;x;x;.;.;.;.;.;.;.;.;.;x;x;x;_;_;_;x;x;.;.;.;.;.;.;.;.;.;.;.;.;.;.;.;.;.;.;.;.;.;.;x;x;x;.;.;.;.;.;.;.;.;.;.;.;x;
x;.;.;.;.;.;.;.;.;.;.;x;_;_;_;x;x;.;.;.;.;.;.;.;.;.;.;.;.;.;.;.;.;.;.;.;.;.;.;.;.;.;.;.;.;.;.;.;.;.;.;.;.;.;.;.;.;x;x;_;_;x;.;.;.;.;.;.;.;.;.;.;.;.;.;.;.;.;.;.;.;.;.;.;x;x;_;x;x;.;.;.;.;.;.;.;.;.;.;x;
x;x;.;.;.;.;.;.;.;.;.;x;_;_;_;_;x;x;.;.;.;.;.;x;x;x;.;m;.;r;.;.;.;.;.;.;.;.;.;.;.;.;.;.;.;.;f;.;.;.;.;.;.;.;.;.;.;.;x;x;x;x;.;.;.;.;.;.;.;.;.;.;.;.;.;.;.;.;.;.;.;m;.;.;x;x;x;x;x;x;x;.;.;.;.;.;.;.;.;x;
x;.;.;.;.;.;.;.;.;.;.;x;_;_;_;_;_;x;x;x;.;.;.;x;x;x;.;.;.;.;.;.;.;.;.;.;.;.;.;.;.;.;.;.;.;.;.;.;.;.;.;.;.;.;.;.;m;.;.;.;.;.;.;.;.;.;.;.;.;.;.;.;.;.;.;.;.;.;.;.;.;.;.;.;.;.;.;.;x;x;x;x;.;.;.;.;.;.;x;x;
x;x;.;.;.;.;.;.;.;.;x;x;x;x;x;x;_;_;_;x;.;.;.;x;.;x;x;x;.;.;.;.;.;.;.;.;.;.;.;.;.;.;.;.;.;.;.;.;.;.;.;.;.;.;.;.;.;.;.;.;.;.;.;.;.;.;.;.;.;.;.;.;.;.;.;f;.;.;.;.;.;.;.;.;.;.;.;.;.;x;_;x;x;.;.;.;x;x;x;_;
x;.;.;.;.;.;.;.;.;.;x;x;.;.;.;x;_;_;_;x;.;.;.;.;.;x;.;x;.;.;.;.;.;.;x;x;x;.;.;.;.;.;.;.;.;.;.;.;.;.;.;.;x;.;.;.;.;.;.;.;.;.;.;.;.;.;.;.;.;.;.;.;.;.;.;.;.;.;.;.;.;.;.;.;.;.;.;.;x;x;_;_;x;x;x;.;x;x;x;_;
x;x;.;.;.;.;.;.;x;x;.;.;.;.;x;x;_;_;_;x;.;.;.;.;.;.;.;x;.;.;.;.;.;.;x;_;x;x;x;x;.;.;.;.;.;.;.;.;.;.;f;.;.;.;.;.;.;.;.;.;.;.;.;.;.;.;.;.;.;.;.;.;.;.;.;.;.;.;.;.;.;.;.;.;.;.;.;.;x;_;_;_;x;x;.;.;.;.;x;x;
x;.;.;.;.;.;.;.;.;.;.;.;.;.;.;x;_;_;_;x;.;.;.;.;.;.;.;.;.;.;.;.;x;x;x;_;_;_;_;x;.;.;.;x;.;.;.;.;.;.;.;.;.;.;.;.;.;.;.;.;.;.;.;.;.;.;.;.;.;.;.;.;.;.;.;.;.;.;.;.;.;.;.;.;.;.;.;.;x;_;_;x;x;.;.;.;.;.;.;x;
x;.;.;.;m;.;.;.;.;.;.;.;.;.;x;x;_;_;_;x;.;.;.;.;.;.;.;.;.;.;.;x;x;x;x;x;x;x;x;x;.;.;.;x;x;.;.;.;.;.;.;.;.;.;.;.;.;.;.;.;.;.;.;.;.;.;x;x;x;x;.;.;.;.;.;.;.;.;.;.;x;x;x;x;x;.;.;.;x;_;_;x;.;.;.;.;f;.;.;x;
x;.;.;.;.;.;.;.;.;.;.;.;.;.;.;x;_;_;_;x;x;.;.;.;.;.;.;.;.;.;.;x;_;x;.;.;.;.;x;x;x;.;x;x;x;.;.;.;.;.;.;.;.;.;.;.;.;.;.;r;.;x;x;.;.;.;.;.;x;x;.;.;.;.;.;.;.;.;.;.;.;x;_;x;.;.;.;.;x;x;_;x;x;.;.;.;.;.;.;x;
x;x;.;.;.;.;.;.;.;.;.;.;.;.;.;x;x;x;_;_;x;x;.;.;.;.;.;.;.;.;.;x;x;x;.;.;.;.;x;x;x;.;x;_;x;x;.;.;.;.;.;.;.;.;.;.;.;.;.;.;.;x;x;x;x;.;.;.;.;.;.;.;.;.;.;0;.;.;.;.;x;x;_;x;.;.;.;.;.;x;x;_;x;.;.;.;.;.;.;x;
x;.;.;.;.;.;.;.;.;.;.;.;.;.;.;.;.;x;x;_;_;x;.;.;.;.;.;.;.;.;.;x;x;.;.;.;.;.;.;x;x;x;x;x;x;x;x;x;.;.;.;.;.;.;.;.;.;.;.;.;.;.;x;x;x;.;.;.;.;.;.;.;.;.;.;.;.;.;.;.;x;_;_;x;.;.;.;.;.;.;x;x;x;.;.;.;.;.;.;x;
x;x;.;.;.;.;.;.;.;.;.;.;.;.;.;.;.;.;x;x;_;x;.;.;f;.;.;.;.;.;.;.;.;.;.;.;.;.;.;.;x;.;x;x;.;.;.;x;x;.;.;.;.;.;.;.;.;.;.;.;.;.;.;x;x;.;.;.;.;.;.;.;.;.;.;.;.;.;.;x;x;x;x;x;.;.;.;.;.;.;.;.;.;.;.;.;.;.;.;x;
x;.;.;.;.;.;.;.;.;.;.;x;.;.;.;.;.;.;.;x;x;x;.;.;.;.;.;.;.;.;.;.;.;.;.;.;.;.;.;.;.;.;x;x;x;x;x;x;x;x;.;.;.;.;.;.;.;.;.;.;.;.;.;.;x;x;.;.;.;.;.;.;.;.;.;.;.;.;x;x;_;x;.;.;.;.;.;.;.;.;.;.;.;.;.;.;.;.;.;x;
x;x;.;.;.;.;.;.;.;.;.;.;.;.;.;.;.;.;.;x;.;.;.;.;.;.;.;.;.;.;.;.;.;.;.;.;.;.;.;.;.;.;x;x;.;.;.;x;_;x;x;.;.;.;.;.;.;.;.;.;.;.;.;.;x;x;.;.;.;.;.;.;.;.;.;.;.;.;x;_;x;x;.;.;.;.;.;.;.;.;.;.;.;.;.;.;.;.;.;x;
x;.;.;.;.;.;.;.;.;.;.;.;.;.;.;.;.;.;.;x;x;.;.;.;.;f;.;.;.;.;.;.;.;.;.;.;.;.;.;.;x;x;x;x;x;x;x;x;_;_;x;x;x;.;.;x;x;x;x;.;.;.;.;.;x;x;.;.;.;.;.;x;x;.;.;.;.;x;x;_;x;.;.;.;.;.;.;.;.;.;.;.;.;.;.;.;.;.;.;x;
x;x;.;.;.;.;.;.;.;.;.;.;.;.;.;.;.;.;.;.;.;.;.;.;.;.;.;.;.;.;.;.;.;.;.;.;.;.;.;x;x;_;_;_;_;_;_;_;_;_;_;_;x;x;x;x;_;_;x;.;.;.;.;.;.;x;.;.;.;.;.;x;x;x;x;x;x;x;_;_;x;x;.;.;.;.;x;.;.;.;.;.;.;.;.;.;.;.;.;x;
x;.;.;.;.;r;.;.;.;.;.;.;.;.;.;.;.;.;x;.;.;.;.;.;.;.;.;.;.;.;.;.;.;.;.;.;.;.;.;x;x;x;x;x;_;_;_;x;x;x;x;x;x;x;x;x;_;_;x;x;.;.;.;.;.;.;.;.;.;.;.;x;x;x;x;.;x;x;x;x;x;.;.;.;x;.;x;.;.;.;.;.;.;.;.;.;.;.;.;x;
x;.;.;.;.;.;.;.;.;.;.;.;.;.;.;.;x;x;x;.;.;.;.;.;.;.;x;.;.;.;.;.;.;.;.;.;.;.;x;x;x;.;.;x;x;_;x;x;.;.;.;x;.;x;.;x;_;_;_;x;.;.;.;.;.;.;.;x;.;.;.;.;.;x;x;x;x;.;.;.;x;.;x;x;x;.;x;.;x;.;.;.;.;.;.;.;.;.;.;x;
x;.;.;.;.;.;.;.;.;.;.;.;.;.;x;x;x;x;.;.;.;.;.;.;.;.;.;.;.;.;.;.;x;x;.;.;.;.;x;x;.;.;.;.;x;x;x;.;.;.;.;.;.;.;.;x;x;_;_;x;x;x;.;.;.;.;.;.;.;.;.;.;.;x;x;.;.;.;.;.;.;.;x;_;x;.;x;.;x;.;x;.;x;.;.;.;.;.;.;x;
x;.;.;.;.;.;x;.;.;.;.;.;.;.;x;x;x;.;.;.;.;.;.;.;.;.;.;.;.;.;x;x;x;x;x;x;x;x;x;x;x;.;.;.;x;.;.;.;.;.;.;.;.;.;.;.;x;_;_;_;_;x;.;.;.;.;.;.;.;.;.;.;.;x;x;.;.;.;.;.;.;x;x;_;x;.;x;.;x;x;x;x;x;.;.;.;.;.;.;x;
x;.;.;.;.;.;x;x;x;.;x;.;.;.;x;x;.;.;.;.;.;.;.;.;.;.;.;.;.;.;.;.;x;_;_;_;_;_;_;_;x;.;.;.;.;.;.;.;.;.;.;.;.;.;.;x;x;_;_;_;_;x;.;.;.;.;.;.;.;.;.;.;.;.;x;.;.;.;.;.;x;x;_;_;x;x;x;x;x;_;x;x;x;.;.;.;.;.;.;x;
x;.;.;.;.;.;.;x;x;x;.;.;.;.;x;x;.;.;.;.;.;.;.;.;.;.;.;.;.;.;.;.;x;x;_;_;_;_;_;x;x;x;x;.;.;.;.;.;.;.;.;.;.;.;.;.;x;_;_;_;_;x;.;.;.;.;.;.;.;.;.;.;.;.;x;.;.;.;x;x;x;_;_;_;_;_;_;_;x;x;x;.;.;.;.;.;.;.;.;x;
x;.;.;.;.;.;.;x;x;x;x;x;x;x;x;x;.;.;m;.;.;.;.;.;.;.;.;.;.;.;.;.;.;x;_;x;x;x;x;x;.;.;x;x;.;.;.;.;.;.;.;.;.;.;.;.;x;_;_;_;_;x;.;.;.;.;.;.;.;.;.;.;.;.;x;x;x;x;x;_;_;_;x;x;x;_;_;x;x;.;.;.;.;.;.;.;.;.;.;x;
x;.;.;.;.;.;.;.;x;x;.;.;.;x;x;x;.;.;.;.;.;.;.;x;.;.;.;.;.;.;.;.;.;x;x;x;.;.;.;.;.;.;.;.;.;.;.;.;.;.;.;.;.;.;.;.;x;x;_;_;_;x;.;.;.;.;.;.;.;.;.;.;.;.;x;_;x;x;x;_;_;_;x;.;x;x;x;x;.;.;.;.;.;.;.;.;.;.;.;x;
x;.;.;.;.;.;.;.;.;.;.;.;.;x;.;.;.;.;.;.;.;.;x;x;x;.;.;.;.;.;.;.;.;.;.;.;.;.;.;.;.;.;.;.;.;.;.;.;.;.;.;.;.;.;.;.;.;x;x;x;_;x;x;x;.;.;x;.;.;.;.;.;.;.;x;x;x;.;x;x;x;_;x;.;.;.;.;.;.;.;.;.;.;.;.;.;.;.;.;x;
x;.;.;.;.;.;.;.;.;.;.;.;.;.;.;.;.;.;.;.;.;.;.;x;x;.;.;.;.;.;.;.;.;.;.;.;.;.;.;.;.;.;.;.;.;r;.;.;.;.;.;.;.;.;.;.;.;x;.;x;x;x;x;x;x;x;x;.;.;.;.;.;.;.;.;.;.;.;.;.;x;_;x;.;.;.;.;.;.;.;.;.;.;.;.;.;.;.;.;x;
x;.;.;.;.;.;.;.;f;.;.;.;.;.;.;.;.;.;.;.;.;.;x;x;x;.;.;.;.;.;.;.;.;.;.;.;.;.;.;.;.;.;.;.;.;.;.;.;.;.;.;.;.;.;.;.;.;.;.;.;.;.;x;x;x;_;x;.;.;.;.;.;.;.;.;.;.;.;.;.;x;_;x;x;.;.;.;.;.;.;.;.;.;.;.;.;.;.;.;x;
x;x;.;.;.;.;.;.;.;.;.;f;.;.;.;.;.;.;.;.;.;.;x;_;x;.;.;.;.;.;.;.;.;.;.;.;.;.;.;.;.;.;.;.;.;.;.;.;.;.;.;.;.;.;.;.;.;.;.;.;.;.;.;.;x;x;x;.;.;.;.;.;.;.;.;.;.;m;.;.;x;x;x;x;x;.;.;f;.;.;.;.;.;.;.;m;.;.;.;x;
_;x;x;.;.;.;.;.;.;.;.;.;.;.;.;.;.;.;.;.;.;x;x;x;x;.;.;.;.;.;.;.;.;.;.;.;.;.;.;.;.;.;.;.;.;.;x;x;x;.;.;.;x;.;x;.;.;.;.;.;.;.;.;.;.;x;x;.;.;.;.;.;.;.;.;.;.;.;.;x;x;x;.;.;.;.;.;.;.;.;.;.;.;.;.;.;.;.;.;x;
x;x;.;.;.;.;.;.;.;.;x;.;.;.;.;.;.;.;.;.;.;x;x;x;.;.;.;.;.;.;.;.;.;.;.;.;.;.;.;.;.;.;.;.;x;x;x;x;x;x;x;.;x;x;.;.;.;.;.;.;.;.;.;.;.;.;x;.;.;.;.;.;.;.;.;.;.;x;x;x;x;.;.;.;.;.;.;.;.;.;.;x;x;.;.;.;.;.;.;x;
x;.;.;.;.;.;.;.;.;.;x;.;.;.;.;.;.;.;.;.;x;x;x;.;.;.;.;.;.;.;.;.;.;.;.;.;.;.;.;.;.;.;.;.;.;.;.;x;x;x;.;x;x;.;.;.;.;.;.;.;.;.;.;.;.;.;x;.;.;.;.;.;.;.;.;.;x;x;_;x;.;.;.;.;.;.;.;.;.;.;x;x;.;.;.;.;.;.;.;x;
x;.;.;.;.;.;.;.;.;x;x;.;.;.;.;.;.;.;.;.;.;x;x;.;.;.;.;.;.;.;.;.;x;.;.;.;.;.;.;.;.;.;.;.;.;.;.;.;.;x;.;x;.;.;.;.;.;.;.;.;.;.;.;.;.;.;x;x;.;.;.;.;.;.;.;.;x;x;x;x;.;.;.;.;.;x;x;x;.;.;.;x;x;.;.;.;.;.;.;x;
x;.;.;.;.;.;.;.;.;.;.;.;.;r;.;.;.;.;.;.;.;.;.;.;.;.;.;.;.;.;.;.;x;.;x;.;.;.;.;.;.;.;.;.;.;.;.;.;.;.;.;.;.;.;.;.;.;.;.;.;.;.;.;.;.;.;x;x;x;.;.;.;.;.;.;.;.;.;x;x;x;.;f;.;.;.;x;x;.;x;x;x;x;.;.;.;.;.;.;x;
x;.;.;.;.;.;.;.;.;.;.;.;.;.;.;.;.;.;.;.;.;.;.;.;.;.;.;.;.;.;.;.;x;x;x;x;.;.;.;.;.;.;r;.;.;.;.;.;.;.;.;.;.;.;.;.;.;.;.;.;.;.;.;.;.;.;.;x;x;.;.;.;.;.;.;.;.;.;x;_;x;.;.;.;.;x;x;x;x;x;_;_;x;x;.;.;.;.;.;x;
x;.;.;.;.;.;.;.;.;.;.;.;.;.;.;.;.;x;.;.;.;.;.;.;.;.;.;.;.;.;.;.;x;_;_;x;.;.;.;.;.;.;.;.;.;.;.;.;.;.;.;.;.;.;.;.;.;.;.;.;.;.;.;.;.;.;.;x;x;x;.;.;.;.;.;.;.;x;x;_;x;x;.;.;.;.;x;_;_;_;_;_;_;x;.;.;.;.;.;x;
x;x;.;.;.;.;.;.;x;x;x;x;x;.;.;.;.;.;.;.;.;.;.;.;.;.;.;.;.;.;.;.;x;_;_;x;x;.;.;.;.;.;.;.;x;.;.;.;.;.;.;.;.;.;.;.;.;.;.;.;.;.;.;.;.;.;.;x;_;x;x;.;.;.;.;.;.;x;x;x;x;.;.;.;.;.;x;x;x;_;_;_;_;x;x;.;.;.;x;x;
x;x;.;.;.;.;.;.;.;x;_;x;.;x;.;.;.;.;.;.;.;.;.;.;.;.;.;.;.;.;.;.;x;x;_;_;x;x;.;.;.;.;.;.;x;.;.;.;.;.;.;.;.;.;.;.;.;.;.;.;.;.;.;.;.;.;.;x;x;x;.;.;.;.;.;.;x;x;.;x;.;x;.;.;.;.;.;.;x;_;_;_;_;_;x;.;.;.;x;_;
x;.;.;.;.;.;.;.;x;x;x;x;.;.;.;.;r;.;.;.;.;.;.;.;.;.;.;.;.;.;.;.;.;x;_;x;x;x;.;.;.;.;.;.;x;x;.;.;.;.;.;.;.;.;.;.;.;.;.;.;.;.;.;.;.;.;.;x;x;.;.;.;.;.;.;.;x;.;.;.;.;.;.;.;.;x;x;x;x;x;x;_;_;_;x;.;.;.;x;_;
x;.;.;.;.;.;.;.;.;x;.;.;.;.;.;.;.;.;.;.;.;.;.;.;.;.;.;.;.;.;.;.;.;x;x;x;.;x;.;.;.;.;.;x;x;x;.;.;.;.;.;.;.;.;.;.;.;.;p;.;.;.;.;.;.;.;.;.;.;.;.;.;.;.;.;.;.;.;.;.;.;x;x;x;x;.;.;.;.;.;x;_;_;_;x;.;.;.;x;x;
x;.;.;.;.;.;.;.;.;x;.;.;.;.;.;.;.;.;.;.;.;.;.;.;.;.;.;.;.;.;.;.;.;.;x;x;.;.;.;.;.;.;.;x;_;x;.;.;.;.;.;.;.;.;x;.;.;.;.;.;.;.;.;.;.;.;.;.;.;.;.;.;.;.;.;x;.;.;.;.;.;.;x;_;x;x;.;.;.;x;x;_;_;_;x;.;.;.;.;x;
x;.;.;.;.;.;.;.;.;.;.;.;.;.;r;.;.;.;.;.;.;.;.;.;.;.;.;.;.;.;.;.;.;x;.;.;.;.;.;.;.;.;x;x;_;x;.;.;.;.;.;.;.;x;x;.;.;.;.;.;.;.;.;.;.;.;.;.;.;.;.;.;.;.;.;x;.;.;.;.;.;.;x;_;x;.;.;.;.;.;x;x;_;_;x;.;.;.;.;x;
x;.;.;.;.;.;.;.;.;x;.;.;.;.;.;.;.;.;.;x;.;.;.;.;.;.;.;.;.;.;.;.;.;.;.;.;.;.;.;.;.;.;x;_;_;x;.;.;.;.;.;.;.;.;x;.;.;.;.;.;.;.;.;x;x;.;.;.;.;.;.;.;.;.;.;x;.;.;.;.;.;.;x;x;x;.;.;.;.;.;.;x;x;x;x;.;.;r;.;x;
x;.;.;.;.;.;.;.;x;.;.;.;.;.;.;.;x;x;x;x;.;x;.;.;.;.;.;.;.;.;f;.;.;.;x;.;.;.;.;.;.;.;x;x;x;x;.;.;.;.;.;.;.;.;.;.;.;.;.;.;.;.;.;x;x;.;.;.;.;.;.;.;.;.;.;.;.;.;.;.;.;.;x;x;.;.;.;.;.;.;.;x;.;x;x;x;.;.;.;x;
x;.;.;.;.;.;.;x;x;.;.;.;.;.;.;.;.;x;x;x;x;.;.;.;.;.;.;.;.;.;.;.;.;.;.;.;.;.;.;.;.;.;.;.;.;.;.;.;.;.;.;.;.;.;.;.;.;.;.;.;.;.;.;.;.;.;.;.;.;.;.;.;.;.;.;.;.;.;.;.;.;x;x;x;.;.;.;.;.;.;.;.;.;.;x;x;x;.;x;x;
x;x;.;.;.;.;.;x;x;.;r;.;.;.;.;.;.;.;.;x;x;x;x;x;x;.;.;.;.;.;.;.;.;.;x;x;x;x;x;.;.;.;.;.;.;.;f;.;.;.;.;.;.;.;.;.;.;r;.;.;.;.;.;.;.;.;.;.;.;.;.;.;.;.;.;.;.;.;.;.;.;.;x;x;.;.;.;.;.;.;.;.;.;.;.;.;.;.;x;x;
_;x;x;.;.;.;x;x;.;.;.;.;.;.;.;.;.;.;.;x;x;_;_;_;x;.;.;.;.;.;.;.;.;.;.;x;_;_;x;x;.;.;.;.;.;.;.;.;.;.;.;.;.;.;.;.;.;.;.;.;.;.;.;.;.;.;.;.;.;.;.;.;.;.;.;.;.;.;.;.;.;.;x;x;.;.;.;.;.;.;.;.;.;.;.;.;.;.;.;x;
_;x;x;x;x;x;x;.;.;.;.;.;.;.;.;.;.;.;.;.;x;_;_;_;x;x;x;.;.;.;.;.;.;.;.;x;x;_;x;x;.;.;.;.;.;.;.;.;.;.;.;.;.;.;.;.;.;.;.;.;.;.;.;.;.;.;.;.;.;.;.;.;.;.;.;.;.;.;.;.;.;.;.;x;.;.;.;.;.;x;x;.;.;.;.;.;.;.;.;x;
x;x;.;.;.;.;.;.;.;.;.;.;.;.;.;.;.;.;.;.;x;x;x;_;_;_;x;x;x;.;.;.;.;.;.;.;x;_;x;.;.;.;.;.;.;.;.;.;.;.;.;.;.;.;.;.;.;.;.;.;.;.;.;.;.;.;.;.;.;.;.;.;.;.;.;.;.;.;.;.;.;.;.;.;.;.;.;.;.;x;x;.;.;.;.;.;.;.;.;x;
x;.;.;.;.;.;.;.;.;.;.;.;.;.;.;.;.;.;.;.;.;.;x;x;x;x;x;x;.;.;.;.;.;.;.;.;x;_;x;.;.;.;.;.;.;.;.;.;.;.;.;.;.;.;.;.;.;x;.;.;.;.;.;.;.;.;.;.;.;.;.;.;.;.;.;.;.;.;.;.;.;.;.;.;.;.;.;.;x;x;x;.;.;.;.;.;.;.;.;x;
x;.;.;.;.;.;.;.;.;.;.;.;.;.;.;.;.;.;.;.;.;.;.;.;x;x;.;.;.;.;.;.;.;.;.;.;x;_;x;.;.;.;.;.;.;.;.;.;.;.;.;.;.;.;.;.;.;.;.;.;.;.;.;.;.;.;.;.;.;.;.;.;.;.;.;.;.;.;.;.;.;.;.;.;.;.;.;.;.;x;x;.;.;m;.;.;.;.;.;x;
x;.;.;.;.;.;x;.;.;.;.;.;.;.;.;.;.;.;.;.;.;.;.;.;.;.;.;.;.;.;.;.;.;.;.;.;x;_;x;.;.;.;.;.;.;.;.;.;.;.;.;.;.;.;.;.;.;r;.;.;.;.;.;.;.;.;.;.;.;.;.;.;.;.;.;.;.;.;.;.;.;.;.;.;.;.;.;.;x;x;x;.;.;.;.;.;.;.;x;x;
x;.;.;.;.;.;x;x;x;.;.;.;.;.;.;.;.;.;.;.;.;.;.;.;.;.;.;.;.;.;.;.;.;.;.;.;x;_;x;.;.;.;.;.;.;.;.;.;.;.;.;.;.;.;.;.;.;.;.;.;.;.;.;.;.;.;.;.;.;.;.;.;.;.;.;.;.;.;.;.;.;.;.;.;.;.;.;.;.;x;x;.;.;.;.;.;.;x;x;_;
x;.;.;.;.;.;.;x;.;.;.;.;.;.;.;.;.;.;.;.;.;.;.;.;.;.;.;.;.;.;.;.;.;.;.;x;x;_;x;.;.;.;.;.;.;.;.;.;.;.;.;.;.;.;.;.;.;.;.;x;.;.;.;.;.;.;.;.;.;.;.;.;.;.;.;x;x;.;.;.;.;.;.;.;.;.;.;.;.;.;.;.;.;.;.;.;x;x;_;_;
x;.;.;.;.;.;.;.;.;.;.;.;.;.;.;.;f;.;.;.;.;.;.;.;.;.;.;x;x;.;.;.;.;.;.;x;_;x;x;.;.;.;f;.;.;.;.;.;.;.;.;.;.;r;.;.;.;.;x;x;.;.;.;.;.;.;.;.;.;.;.;.;.;x;x;x;x;.;.;.;.;.;.;.;.;.;.;.;.;.;.;.;.;.;x;x;x;_;_;_;
x;.;.;.;.;.;.;.;.;.;.;.;.;.;.;.;.;.;.;.;.;.;.;.;.;.;.;x;x;.;.;.;.;.;.;x;_;x;.;.;.;.;.;.;.;.;.;x;x;.;.;.;.;.;.;.;x;x;x;.;.;.;.;.;.;.;.;.;.;.;.;.;.;.;.;x;.;.;.;.;.;.;.;.;.;.;.;.;.;.;.;.;.;.;x;_;x;x;x;_;
x;.;.;.;.;.;.;.;.;.;.;.;.;.;.;.;.;.;.;.;.;.;.;.;.;.;.;x;x;.;.;.;.;.;.;x;x;x;.;.;.;.;.;.;.;.;.;x;x;.;.;.;.;.;.;x;x;.;x;.;.;.;.;.;.;.;.;x;x;x;.;.;.;.;.;.;.;.;.;.;.;x;.;.;.;.;x;x;x;.;.;.;.;.;x;x;x;.;x;x;
x;.;x;.;x;x;.;.;.;.;.;.;.;.;.;.;.;.;.;.;.;.;.;.;.;.;.;.;.;.;.;.;.;.;.;x;.;.;.;.;.;.;.;.;.;.;.;.;x;.;.;.;.;.;.;x;.;.;.;.;.;.;.;.;.;.;.;.;.;x;x;.;.;.;.;.;.;.;.;.;.;x;.;.;.;.;x;x;x;.;.;.;.;.;.;x;x;.;.;x;
x;.;x;.;x;x;x;x;.;.;.;.;.;.;.;.;x;x;x;x;x;.;.;.;.;.;r;.;.;.;.;.;.;.;.;.;.;.;.;.;.;.;.;.;.;.;.;.;.;.;.;.;.;.;.;.;.;.;.;.;.;.;.;.;.;.;.;.;.;x;x;.;.;.;.;.;.;.;.;.;.;x;x;.;.;.;.;x;x;x;.;.;.;.;.;.;.;.;.;x;
x;.;x;.;x;_;x;x;.;.;.;.;.;.;.;.;.;x;_;_;x;x;.;.;.;.;.;.;.;.;.;.;.;.;.;.;.;.;.;.;.;.;.;.;.;.;.;.;.;.;.;.;.;.;r;.;.;.;.;.;.;.;.;.;.;.;.;.;.;.;.;.;.;.;.;.;.;.;.;.;.;x;.;.;.;.;x;x;_;x;x;.;.;.;.;.;x;x;.;x;
x;.;x;.;x;x;x;.;.;.;.;.;.;.;.;.;.;x;x;_;_;x;.;.;.;.;.;.;.;.;.;.;.;.;.;.;.;.;.;.;.;.;.;.;.;.;.;.;.;.;.;.;.;.;.;.;.;.;.;.;.;x;.;.;.;.;.;.;.;.;.;.;f;.;.;.;.;.;.;.;.;.;.;.;.;.;x;_;_;_;x;x;.;.;.;.;x;x;x;x;
x;.;.;.;x;.;.;.;.;.;.;.;.;.;.;.;.;.;x;_;_;x;x;.;.;f;.;.;.;.;.;.;.;.;.;.;.;.;.;.;.;.;.;.;.;.;.;.;.;.;.;.;.;.;.;x;x;.;.;.;.;.;.;x;.;.;.;.;.;.;.;.;.;.;.;.;.;.;.;x;x;x;.;.;.;x;x;_;_;_;_;x;.;.;.;x;x;x;_;_;
x;.;.;.;x;.;.;.;.;.;.;.;.;.;.;.;.;x;x;_;x;x;x;x;.;.;.;.;.;.;.;.;.;.;.;x;.;.;r;.;.;.;.;.;x;x;x;.;.;.;f;.;.;.;.;x;x;x;x;x;.;.;.;.;.;.;.;.;.;.;.;.;.;.;r;.;x;.;x;x;x;x;.;.;.;x;x;x;_;_;_;x;x;x;.;x;.;x;_;_;
x;.;.;.;x;.;.;.;r;.;.;.;.;.;.;.;.;x;x;x;x;.;.;x;x;x;.;.;x;x;x;x;x;.;.;.;.;.;.;.;.;.;.;.;x;x;x;x;.;.;.;.;.;.;.;x;x;x;.;.;.;.;.;.;.;.;.;.;.;.;.;.;.;.;.;.;.;.;x;_;x;.;.;.;.;.;.;x;x;x;_;_;x;.;.;.;.;x;_;_;
x;x;x;x;x;x;.;.;.;.;.;.;.;.;.;.;x;x;x;.;.;.;.;.;.;x;x;x;x;.;x;.;x;.;.;.;.;.;.;.;.;.;.;.;.;x;_;x;.;.;.;.;.;.;.;.;.;x;.;.;.;.;.;.;.;.;.;.;.;.;.;.;.;.;.;x;x;.;x;x;x;.;.;.;.;.;.;.;.;x;_;_;x;x;.;.;.;x;_;_;
_;_;_;_;_;x;x;.;.;.;.;.;.;.;.;x;x;_;x;x;.;.;.;.;.;.;.;.;.;.;.;.;.;.;.;.;.;.;.;.;.;.;.;.;.;x;_;x;.;.;.;.;.;.;.;.;.;.;.;.;.;.;.;.;.;.;.;.;.;.;.;.;.;.;.;x;x;x;x;x;.;.;.;.;.;.;.;.;.;x;_;_;x;.;.;.;.;x;x;x;
_;_;_;_;_;_;x;x;x;x;x;x;x;x;x;x;_;_;_;x;.;.;.;.;.;.;.;.;.;.;.;.;.;.;.;.;.;.;.;.;r;.;.;.;.;x;_;x;x;.;.;.;.;.;.;.;.;f;.;.;.;.;.;.;.;.;.;.;.;.;.;f;.;.;.;.;x;x;x;x;.;.;.;.;.;.;.;.;.;x;_;_;x;x;.;.;.;.;.;x;
_;_;_;_;_;_;x;x;x;.;.;x;_;_;_;_;x;x;x;x;x;x;.;x;.;.;.;.;.;.;.;.;.;.;.;.;.;.;.;.;.;.;.;x;x;x;_;_;x;x;.;.;.;.;.;.;.;.;.;.;.;.;.;.;.;.;.;.;.;.;.;.;.;.;.;.;.;.;.;.;.;.;.;.;.;.;.;.;.;x;x;_;_;x;.;x;.;x;x;x;
_;x;x;x;_;x;x;.;.;.;.;x;_;_;x;x;x;.;.;.;.;x;x;x;.;x;.;.;.;.;.;.;.;.;.;.;.;.;x;x;x;x;x;x;_;_;_;_;_;x;x;x;x;.;.;.;.;.;.;.;.;.;.;.;.;.;.;.;.;.;x;x;x;.;x;.;.;.;.;.;.;r;.;.;.;.;.;.;.;.;x;x;x;x;x;x;x;x;_;_;
_;x;.;x;x;x;.;.;.;.;.;x;_;_;x;.;.;.;.;.;.;x;x;x;x;x;x;x;x;x;x;.;.;.;x;.;x;.;x;x;x;x;_;_;_;_;_;_;_;_;_;_;x;.;.;.;.;.;.;.;.;.;.;.;.;.;.;.;.;.;x;x;x;.;.;.;.;.;.;.;.;.;.;.;.;.;.;.;.;.;.;.;x;x;_;_;_;_;_;_;
x;x;.;x;x;.;.;.;.;.;.;x;x;x;x;.;.;.;.;.;.;.;x;_;_;_;_;_;_;_;x;x;x;.;.;.;.;x;x;x;.;x;x;x;x;x;_;_;_;_;_;x;x;.;.;.;.;m;.;.;.;.;.;.;.;.;.;.;.;.;x;x;.;.;x;x;x;.;x;.;.;.;.;.;.;.;.;.;.;.;.;.;.;x;x;_;_;_;_;_;
x;.;.;.;x;.;.;.;.;.;.;.;x;x;.;.;.;.;.;.;.;.;x;x;_;_;_;_;_;_;_;_;x;.;.;.;.;.;.;.;.;.;.;.;.;x;x;x;_;_;x;x;.;.;.;.;.;.;.;.;.;.;.;.;.;.;.;.;.;.;x;.;.;.;.;x;x;x;x;x;x;.;.;.;.;.;.;.;.;.;.;.;.;.;x;_;_;_;_;_;
x;x;.;x;x;x;.;.;.;.;.;x;x;x;x;.;.;.;.;.;.;.;.;x;_;_;_;_;_;_;_;x;x;.;.;.;.;.;.;.;.;.;.;.;.;.;.;x;_;_;x;.;.;.;.;.;.;.;.;.;.;.;.;.;.;.;.;.;.;.;.;.;.;.;.;.;x;x;x;_;x;x;x;x;x;x;.;.;.;.;.;.;.;.;x;x;_;_;_;_;
_;x;.;x;_;x;x;.;.;.;.;.;x;_;x;.;.;.;.;.;.;.;.;x;x;_;_;_;_;_;_;x;.;.;.;.;.;.;.;.;.;.;.;.;.;.;.;x;x;_;x;x;.;.;.;.;.;.;.;.;.;.;.;.;.;.;.;.;.;.;.;.;.;.;.;.;x;.;x;_;_;_;_;_;_;x;.;.;.;.;.;.;.;.;.;x;_;_;_;_;
_;x;x;x;_;_;x;x;x;.;x;x;x;_;x;x;.;.;.;.;.;.;.;.;x;_;_;_;_;_;_;x;x;.;.;.;.;.;.;.;.;.;.;.;.;.;.;.;x;_;_;x;.;.;.;x;x;.;.;.;.;.;.;.;.;.;.;.;.;x;.;.;.;.;.;.;x;.;x;_;_;_;_;_;_;x;.;.;.;.;.;.;.;.;x;x;_;_;_;_;
_;_;_;_;_;_;_;_;x;x;x;_;_;_;_;x;x;x;x;x;x;x;x;x;x;_;_;_;_;_;_;_;x;x;x;x;x;x;x;x;x;x;x;x;x;x;x;x;x;_;_;x;x;x;x;x;x;x;x;x;x;x;x;x;x;x;x;x;x;x;x;x;x;x;x;x;x;x;x;_;_;_;_;_;_;x;x;x;x;x;x;x;x;x;x;_;_;_;_;_;
